id,year,M,W,total,group,supply
64869,2067,3,0,3,D,29.44066615303929
44969,2068,21,2,23,A,28.98077517114407
63616,2068,4,5,9,I,28.81215571671632
46206,2067,10,2,12,A,29.14851065010013
17022,2068,4,6,10,E,28.857358472651093
51152,2067,3,2,5,P,28.95944835928218
103728,2067,5,0,5,Q,28.98387341789997
172811,2067,3,4,7,E,29.09743485678055
82529,2068,3,1,4,E,29.09333632133024
40851,2068,1,1,2,D,28.78720017145278
157354,2068,5,3,8,N,28.79779125149594
73033,2067,4,3,7,N,28.60312152985697
65878,2068,5,2,7,E,28.60602651228076
63165,2067,5,1,6,J,29.09210190505094
59742,2067,5,3,8,D,29.419532747280623
24144,2068,3,0,3,P,28.7815545700846
96707,2068,4,0,4,E,28.693016079950592
166805,2067,5,1,6,E,29.318631693018624
59471,2067,7,1,8,N,29.109269808457597
93434,2068,6,1,7,J,28.6419273222376
58914,2067,5,1,6,E,29.234902685348118
30511,2067,5,2,7,D,28.89814921325165
104545,2068,3,1,4,J,28.679301957251592
26111,2068,10,3,13,N,28.92648028941491
135981,2068,3,0,3,S,28.88526052424255
23581,2068,4,2,6,D,28.986389582618934
114335,2067,11,2,13,Q,29.31506820289465
166974,2068,6,1,7,Q,28.89833525871698
160217,2067,12,0,12,R,29.1647236597297
109148,2068,2,2,4,J,28.584526064619595
41918,2067,4,2,6,G,29.042009234102576
124759,2067,3,4,7,E,29.001483095055217
41954,2068,3,1,4,K,29.282537746962745
63969,2067,2,2,4,D,29.118769871233305
134806,2068,3,3,6,N,28.92522948571011
41557,2067,3,1,4,N,29.225153694237115
92165,2067,7,1,8,J,29.530017876603345
88008,2067,3,1,4,D,28.924920418600998
110248,2068,4,0,4,E,28.89063433848908
169596,2067,2,2,4,N,29.403764584565163
45690,2067,16,1,17,A,29.19379809686236
150315,2068,3,2,5,E,28.67915909391856
158469,2068,5,3,8,M,29.103655095054343
167303,2068,4,3,7,J,29.035333532034706
57178,2068,2,3,5,Q,28.53897361451208
181856,2067,7,3,10,P,29.42575125977591
19445,2067,5,1,6,N,29.251334671504235
47623,2068,2,3,5,D,28.852899839719225
83426,2067,4,0,4,E,29.33181275076468
25530,2068,5,2,7,D,29.10675821200623
160656,2067,2,0,2,N,29.338010410607403
132401,2068,4,2,6,F,29.05809327742159
132289,2068,6,1,7,J,28.483934770388014
141298,2068,5,5,10,N,28.947280923577143
72465,2068,2,3,5,J,29.136391199235018
93443,2068,15,7,22,J,28.77983413739972
84697,2067,7,0,7,H,29.228657948634368
72306,2067,5,1,6,Q,29.32249068161229
91734,2067,3,2,5,D,29.20487192500888
22480,2067,4,2,6,M,29.46817693919207
25121,2068,4,2,6,D,28.935186408300652
128446,2068,7,1,8,K,28.13862014882211
63866,2067,6,1,7,E,28.874840884393898
55521,2067,3,3,6,P,29.353004737970323
54511,2068,3,0,3,P,28.66776746266534
125126,2068,1,2,3,P,28.963799158596757
140506,2067,6,2,8,K,29.04098766105764
121578,2067,2,1,3,J,29.316689102252507
136583,2068,2,2,4,D,29.182464310141597
71724,2067,4,0,4,D,29.012677647071364
108633,2068,6,1,7,J,28.44474786676684
49479,2067,2,4,6,E,28.908375676015083
109078,2067,3,0,3,P,29.014417929493533
121331,2068,7,1,8,J,28.81282913351185
94490,2068,6,1,7,E,28.907694305426705
164450,2067,2,0,2,M,28.993526938700715
39580,2068,2,2,4,G,28.556356516264348
100381,2068,4,2,6,N,28.57882310468558
147077,2068,6,2,8,K,28.77646750706699
145323,2068,5,0,5,M,28.857060134689608
94774,2068,4,2,6,Q,29.254096682374577
83713,2068,6,2,8,M,28.99626877539772
93670,2067,7,0,7,M,29.35687523779296
135486,2067,3,2,5,E,29.371587272693738
53318,2068,7,2,9,Q,28.897027296053448
17762,2068,6,1,7,D,28.632937780629398
124242,2067,5,0,5,P,29.29459020919493
20422,2068,4,2,6,N,28.934605542680508
19262,2067,5,3,8,C,29.2022984518981
29503,2068,4,3,7,E,28.905767019307515
110009,2068,6,0,6,E,28.681009193197536
55466,2067,4,3,7,H,29.1777769394546
166606,2068,7,3,10,L,28.748804339839577
127417,2068,4,6,10,E,28.845465654001707
72826,2068,4,2,6,M,29.014269423477625
157662,2067,5,0,5,N,29.20992265247538
180764,2068,4,1,5,Q,29.28530966490027
164677,2067,4,1,5,D,29.543000800200844
51527,2067,3,2,5,L,29.327058260970176
56920,2068,8,1,9,Q,28.991598374648976
39749,2067,5,1,6,N,29.36690508489577
110596,2068,8,0,8,J,28.96600081156052
86946,2068,3,0,3,K,28.92010595819457
16635,2068,4,3,7,D,28.940317463655
99062,2067,6,0,6,J,29.29305786251343
76637,2067,2,1,3,E,29.31718591725721
174267,2068,4,2,6,J,29.02893633115509
41058,2067,6,2,8,E,29.153090516269355
41544,2067,4,2,6,P,29.011473498997205
107707,2068,1,4,5,E,29.111619393254333
91578,2068,5,1,6,J,28.641718658610447
103511,2067,1,3,4,J,29.32132860823705
40849,2067,7,1,8,E,29.348314610808263
140728,2067,7,4,11,J,28.986793415480435
177404,2067,6,0,6,K,29.02056038443316
83094,2067,1,1,2,N,28.877066704244086
78630,2068,6,1,7,J,29.17458580027478
158869,2068,3,2,5,P,28.90462837044229
133663,2068,7,2,9,M,28.86870298542956
24234,2067,3,2,5,N,28.921961596671316
142874,2067,4,0,4,M,29.340652138795395
39401,2068,3,0,3,N,28.73232668081489
53926,2068,3,2,5,N,28.46593675549009
64491,2067,6,0,6,D,29.17029887767669
84139,2067,6,4,10,I,29.19835097610257
175904,2068,3,1,4,J,29.309537227202565
172607,2067,8,0,8,N,29.410320438093255
83308,2067,5,0,5,E,29.169061182183626
97622,2068,6,1,7,P,28.783878169493743
72263,2067,3,0,3,E,29.089657677051196
159850,2068,4,1,5,E,28.951295280233595
138401,2068,6,2,8,M,28.908785686168013
76136,2067,2,1,3,K,29.411545523463136
78805,2068,4,2,6,E,28.788966073317606
95117,2067,4,2,6,N,29.2089738158931
183093,2067,7,2,9,N,29.31302108675488
60344,2067,3,3,6,K,29.092335042673568
87893,2068,2,0,2,Q,28.810798009169904
148852,2068,8,1,9,N,28.80791747153612
146582,2067,5,2,7,K,29.485236756411854
141530,2068,5,2,7,M,29.375036561095616
120091,2068,5,0,5,K,29.06816826063621
158636,2068,8,0,8,D,28.63151773823849
167277,2068,3,1,4,M,28.927543300942805
21253,2067,6,2,8,Q,29.062588063850388
39885,2067,2,1,3,Q,29.461636314875843
100045,2067,1,3,4,M,29.05006995899988
174502,2068,4,0,4,Q,28.3980553782314
41608,2068,4,0,4,Q,29.115186386933186
59688,2067,2,2,4,J,29.2149720331626
78717,2067,3,2,5,M,29.479430208562285
134932,2068,4,1,5,N,29.13050248672921
103951,2067,5,2,7,N,29.105309117870576
113558,2067,3,2,5,P,28.97988566073836
125065,2068,5,3,8,M,28.769852805603
24652,2068,12,0,12,N,29.064092401651
140479,2067,5,2,7,M,29.214484733003975
89000,2067,6,0,6,E,29.572086153351112
100938,2068,4,0,4,D,28.811573658588987
162578,2068,4,3,7,N,29.03771125855297
71709,2067,7,1,8,I,29.456150605706565
21702,2067,6,5,11,L,29.368561284834566
123309,2067,7,0,7,E,29.28990647440766
95166,2067,5,1,6,M,29.431451954985576
173242,2068,7,2,9,D,28.93667854834496
70636,2068,1,3,4,L,28.85746954238475
132615,2067,4,2,6,E,29.22556536096038
23807,2067,3,1,4,Q,29.323886508649675
157711,2068,5,0,5,N,28.712127084395043
143217,2068,2,3,5,Q,28.89860267271931
116663,2068,2,2,4,J,29.01197032098492
119777,2068,7,2,9,K,28.86354890669088
139651,2067,6,2,8,E,29.15752253791592
56763,2068,7,2,9,M,28.92285346650112
118101,2067,4,4,8,E,29.28382663952856
77829,2068,3,4,7,Q,28.97964450499755
101124,2067,4,3,7,F,29.43193809477903
140602,2068,2,4,6,M,29.19560300444245
123725,2067,2,2,4,M,29.181468355742272
180552,2068,5,3,8,P,28.987165204090807
35507,2068,2,2,4,N,28.980589264610924
98666,2067,5,0,5,N,29.310524242698087
111597,2067,6,0,6,N,29.23853509638842
142159,2068,4,2,6,M,28.98927016799212
107260,2067,4,2,6,P,29.394440843557884
21140,2068,6,0,6,M,28.78469915063573
171034,2067,30,4,34,N,29.374759210210573
29130,2068,7,2,9,J,28.851714624411056
60998,2068,5,1,6,D,28.760909925573568
57429,2068,5,0,5,D,28.837783114901782
117441,2068,5,1,6,P,28.78128137682621
107439,2068,6,0,6,N,29.066483651421184
86639,2067,5,2,7,H,29.377117460866405
169609,2067,2,2,4,J,28.98292549302794
34479,2068,2,3,5,J,28.60384708574517
169846,2067,7,1,8,M,29.258425184585597
87888,2068,5,1,6,D,28.84009844869296
117960,2068,4,2,6,E,29.093141398112543
92537,2068,2,2,4,J,28.717947141868645
55606,2068,4,2,6,S,28.56363219845005
159039,2067,4,1,5,E,28.928847154365396
127073,2068,4,2,6,S,28.775697078114572
31388,2068,2,1,3,Q,29.11355445672708
117067,2068,4,3,7,I,28.86926809642668
49655,2067,6,1,7,E,29.227585364159932
108524,2067,2,2,4,N,29.221185530343465
99435,2068,6,3,9,P,28.71939888895054
53551,2067,4,0,4,Q,29.298040006049305
60200,2067,3,3,6,P,29.144700170665832
107439,2067,3,2,5,N,29.304395895522426
148965,2067,4,2,6,M,29.36565980029225
143515,2067,2,1,3,E,28.848656460054016
174302,2068,10,2,12,D,29.019107386343965
167329,2068,4,2,6,M,29.03862485928764
166511,2067,5,1,6,E,29.223541398364823
32414,2068,6,1,7,Q,28.87634002792831
128204,2067,7,2,9,P,28.884962606634588
88851,2068,6,2,8,M,28.812233561977354
174855,2067,1,1,2,P,29.26614828303232
82403,2068,9,1,10,A,29.03527269705165
160369,2068,7,0,7,P,29.183144185594056
112063,2068,3,2,5,Q,28.83031316234718
62968,2067,2,2,4,E,29.26915999968377
169442,2067,7,2,9,D,29.57505820600677
75699,2068,7,0,7,E,28.766483403063035
58797,2068,3,4,7,E,28.985061627106933
115643,2067,2,0,2,N,29.209734181741467
49002,2068,5,2,7,Q,28.76787369690785
21256,2067,6,2,8,N,29.085575871748738
34241,2068,8,2,10,D,29.046815416829748
45597,2067,6,2,8,E,29.10201289980512
66484,2067,6,3,9,M,29.1783952833578
93366,2067,8,1,9,M,29.41185357246162
130612,2068,5,0,5,P,28.645756089997995
22799,2068,4,0,4,N,28.82502545524024
113370,2068,3,2,5,E,29.09689305177148
96585,2068,6,2,8,N,29.092943259060064
136486,2067,6,1,7,M,29.121519925717045
137372,2067,6,2,8,M,29.130432700227537
172086,2068,4,2,6,D,28.656325718231564
33304,2067,2,3,5,Q,29.226606451607022
170262,2068,4,1,5,J,28.94844920202843
128706,2067,9,0,9,E,29.40332355551108
119264,2067,1,1,2,E,29.137317527984514
98376,2068,5,2,7,A,28.850157315176983
24320,2068,5,3,8,N,28.890409643603917
115959,2067,8,2,10,Q,29.037653010631093
120512,2068,2,3,5,J,29.03955553818062
91848,2067,2,3,5,J,29.04953285537343
45126,2068,4,1,5,E,28.96316694571857
93649,2067,2,3,5,P,29.20196425141494
74130,2068,5,2,7,Q,28.996160836213303
131154,2067,8,1,9,E,29.096749495666728
91879,2068,9,1,10,E,28.823914416019687
120362,2068,5,1,6,J,29.02548492822281
29183,2068,2,2,4,M,29.02787649238572
160461,2067,4,2,6,Q,29.188715062795296
39537,2068,7,1,8,A,28.86908257642772
181683,2067,1,2,3,Q,29.228196156110982
66121,2068,11,2,13,D,28.789474028495235
92899,2067,6,2,8,Q,29.08904880989429
171327,2068,3,2,5,E,28.871900164929656
175054,2067,8,0,8,E,29.10350314673421
53797,2067,4,2,6,D,29.158078326086645
67212,2067,2,1,3,E,29.31010768814157
38292,2067,2,0,2,C,29.33833526771708
176628,2067,3,2,5,N,29.30400335502515
57020,2067,4,2,6,M,29.0814777182887
36595,2068,4,2,6,J,28.65883912504052
71042,2068,6,2,8,K,28.76024398872161
109631,2068,6,2,8,E,28.644439671755464
116774,2067,4,1,5,Q,28.88489811023504
18218,2068,5,2,7,P,28.875073610173217
90667,2068,6,2,8,Q,28.60250850859637
74209,2068,5,0,5,E,28.887958210147676
53947,2068,3,1,4,M,28.767879820389325
30636,2067,4,3,7,I,28.88299532514867
27337,2067,6,1,7,D,29.19603919525892
51886,2067,2,4,6,M,29.14957490415868
129711,2068,3,3,6,N,29.18579405109789
124521,2067,6,1,7,M,29.10283997998853
104955,2068,8,0,8,M,28.896762562094857
56428,2067,3,1,4,J,29.02975134928633
70848,2068,3,1,4,K,29.149379589877057
63556,2067,6,1,7,D,29.102512977434507
25252,2067,5,1,6,E,29.145016453746276
139732,2068,3,2,5,J,28.94024461446801
45453,2068,5,2,7,E,28.93656360347809
149554,2068,8,1,9,M,28.477515706798616
127335,2068,2,0,2,M,28.82248847818715
139709,2068,4,2,6,K,28.92239831587267
101349,2067,5,1,6,N,29.3473998923431
35495,2067,2,4,6,M,29.546583575076856
164694,2067,3,4,7,E,29.480364089236744
87263,2067,8,1,9,L,29.45113927743481
31953,2067,2,3,5,E,29.10161121196327
31989,2068,9,3,12,F,28.82948912374865
135845,2068,4,0,4,J,29.21472182807324
115897,2068,6,0,6,N,28.829886676657463
121096,2067,4,2,6,D,29.436542923997035
145767,2068,5,1,6,M,28.80735798951546
144437,2067,2,3,5,J,28.975627506730003
142038,2067,3,3,6,M,29.11957503340911
144965,2068,5,1,6,M,28.90128576608972
179645,2067,4,1,5,J,28.891610665441235
55943,2068,5,1,6,K,29.052522481000747
56689,2068,3,1,4,K,28.99685830305613
179648,2067,8,0,8,D,29.20318545056309
40439,2068,4,2,6,Q,28.80100911289286
40130,2067,6,2,8,I,29.06250754106344
41762,2067,3,3,6,M,29.21033706473672
173105,2068,7,1,8,L,28.793474371702896
92904,2068,12,4,16,J,28.472068762088785
87183,2067,6,0,6,P,28.995774851342336
86962,2068,3,1,4,N,28.952496385427235
123224,2068,3,2,5,I,28.69240354794291
142763,2068,3,0,3,P,28.831928357165
103835,2068,6,2,8,N,29.025648266209014
54904,2067,2,1,3,Q,29.196980641836465
173114,2068,3,2,5,Q,28.622053521138422
120786,2067,3,1,4,N,29.09784127770888
139106,2068,5,3,8,M,28.86300806820455
65669,2067,3,2,5,N,29.218833320225706
59782,2067,3,1,4,M,29.430082316189548
36073,2067,5,0,5,P,29.26157046311706
122472,2068,2,4,6,N,28.992350353366035
126346,2068,3,0,3,N,28.83032817302815
82451,2068,3,2,5,J,28.76269999118666
20893,2067,8,0,8,F,29.12490140064365
125187,2067,2,4,6,M,29.26540068051403
63781,2068,4,0,4,Q,28.96509937556625
83484,2067,2,2,4,M,29.36864358251388
119082,2068,1,3,4,N,28.68103388740061
167422,2068,7,1,8,M,28.863533011752576
40775,2068,3,3,6,M,29.110800339171423
27616,2068,6,2,8,H,28.440587528192022
131380,2068,5,2,7,N,29.0906521318928
119125,2068,10,5,15,E,28.741400511555568
55323,2068,5,2,7,J,28.779323111542517
117968,2067,3,1,4,H,29.12248965295416
138080,2068,2,1,3,Q,28.76370356800201
162694,2067,7,2,9,N,29.14752971668137
106148,2067,5,0,5,E,29.062386472038707
69144,2067,6,3,9,Q,29.090628814061265
54801,2067,7,1,8,N,29.33660305496199
52621,2067,3,1,4,K,28.948443419444533
170627,2067,5,0,5,E,28.96630708180406
111820,2067,2,2,4,J,29.203801933566847
164868,2068,2,3,5,K,28.92224516033741
21071,2068,4,1,5,M,28.907081933865527
147261,2068,3,2,5,M,28.785283732818545
149999,2068,2,4,6,N,28.641477474152765
39679,2067,6,2,8,N,29.2575364392779
159164,2068,7,1,8,N,28.82049168490162
35464,2068,3,2,5,A,28.92263129987707
130262,2068,5,1,6,N,28.891485905307267
29167,2068,4,1,5,E,29.007164943000102
100805,2068,5,0,5,E,28.597640852066537
160637,2067,2,3,5,S,29.218971142478576
61500,2068,3,2,5,E,28.83646067600308
129022,2067,4,1,5,M,28.969374644399533
127690,2068,8,3,11,M,28.844379751039945
57602,2068,3,0,3,N,29.03714202479904
22918,2068,3,2,5,J,29.17737991472852
60547,2067,10,1,11,N,29.410340562352896
86916,2068,2,1,3,A,28.74544714846315
171530,2068,6,0,6,J,28.970811010802045
110144,2068,6,0,6,C,29.00369659176344
118777,2068,6,2,8,P,28.57670875188139
126702,2068,4,4,8,N,28.92119735338733
137308,2068,6,1,7,P,28.658446263438485
62131,2068,6,1,7,S,28.763863196926405
56317,2067,4,0,4,S,29.326475371377832
180959,2067,4,2,6,M,29.247783588366023
86365,2068,4,1,5,E,29.1327083183158
167365,2068,5,1,6,M,28.556253615810768
28175,2068,5,3,8,E,28.69262453621253
50720,2068,5,1,6,N,28.697027856818345
111542,2068,6,0,6,E,28.906188259814364
163525,2068,5,2,7,J,28.78646951647608
40597,2067,3,1,4,D,29.12272626969668
163544,2068,3,2,5,M,28.75940825777593
35286,2068,4,0,4,D,28.751558715264213
75877,2068,3,1,4,D,28.9987805572489
144175,2067,5,1,6,Q,29.339961546406997
61332,2068,8,2,10,N,28.51596251328638
181476,2068,7,1,8,S,28.84839055394936
159769,2068,4,1,5,Q,29.111950376526146
177626,2067,2,1,3,M,29.280708123828315
90278,2068,5,2,7,M,28.769319404868057
45885,2067,2,1,3,J,29.156954643747216
107937,2067,5,1,6,E,29.23148438763777
151465,2068,3,2,5,M,28.86401656855883
144609,2068,5,0,5,M,28.932937651503487
120928,2067,5,1,6,J,29.37060579320517
128618,2067,3,2,5,M,29.330646277456445
146351,2067,4,0,4,M,29.163184080552803
133930,2068,4,0,4,S,29.064441004883847
143871,2068,5,0,5,P,28.811161615873225
171408,2068,2,3,5,E,28.483573062339065
110774,2068,5,0,5,N,28.71623862339192
123885,2068,2,2,4,A,28.903086752383487
167449,2067,2,3,5,M,28.99612870301071
132354,2068,5,3,8,M,28.618206099057048
68341,2067,3,2,5,J,29.427708503095367
72983,2068,3,0,3,J,28.951558581072664
81947,2067,8,3,11,Q,29.09239584073073
161518,2068,5,1,6,E,29.28392458868748
176847,2067,3,3,6,P,29.134117568237265
109153,2068,5,3,8,J,28.72646573424616
165304,2067,2,1,3,Q,29.378667436871595
33130,2067,6,0,6,K,29.14165179877636
32430,2068,1,2,3,E,28.89686215904874
56918,2068,5,2,7,M,28.76398722160021
145617,2068,6,1,7,D,28.99102293922653
82320,2067,6,1,7,D,29.122728427189852
76396,2067,3,1,4,E,28.875145346549424
140478,2067,7,0,7,C,29.23932044768385
158166,2068,5,2,7,E,28.76371777735215
19000,2068,4,0,4,D,28.670529272046625
126445,2067,5,2,7,J,29.38315825728841
71201,2068,1,2,3,N,29.02505106299433
165328,2068,3,1,4,M,28.78851839670452
55018,2068,2,3,5,M,28.7129414808756
92141,2068,5,3,8,N,29.151490271105526
46207,2067,8,0,8,A,28.925925536589386
121974,2067,4,2,6,N,29.30804495310497
36447,2068,1,3,4,I,28.992910931019257
90612,2068,5,1,6,Q,28.5038099972484
99339,2068,3,2,5,N,28.74307434750232
165486,2067,2,1,3,M,29.34163965037721
19725,2067,2,0,2,J,29.212974557429263
24602,2067,3,3,6,D,29.229694717896837
147791,2068,5,2,7,M,28.617612490773038
83448,2068,3,3,6,N,29.091397591541146
73135,2068,4,2,6,K,28.946898566645874
21540,2068,4,1,5,E,28.773830524907584
144224,2067,6,1,7,M,29.173263851897115
68777,2068,5,1,6,I,28.908405812675596
20170,2067,5,2,7,E,29.39966695047322
23450,2068,2,3,5,E,28.898735154335643
31475,2067,3,2,5,R,29.404325764769567
150033,2068,5,2,7,P,28.77267358416219
112677,2067,4,0,4,J,29.11314737036769
66215,2067,25,6,31,E,29.565086364846035
79039,2068,6,1,7,N,29.092997287965773
46629,2068,6,1,7,D,28.663038741794217
180162,2068,10,1,11,H,28.86089800732693
101603,2068,3,1,4,E,28.84862044180804
129444,2068,4,0,4,Q,28.677244373332687
158635,2067,4,2,6,Q,29.13973447792723
104407,2067,5,4,9,L,29.21228305066748
160517,2067,3,2,5,E,29.14923553072032
124895,2067,5,0,5,M,29.107378495055624
169284,2068,5,1,6,E,29.18555958655673
100343,2068,1,2,3,N,28.65202927070852
65167,2068,4,1,5,D,28.45835200887609
17426,2067,5,0,5,P,29.18672612813411
58742,2068,3,1,4,M,28.812499664208406
125007,2067,6,1,7,H,28.98547628482228
69255,2068,5,1,6,D,28.776961327547205
170216,2068,12,2,14,D,29.10725254063142
101851,2068,3,3,6,D,28.98194323664088
180008,2067,7,4,11,P,29.52005494143691
100594,2068,9,2,11,P,29.00691898490236
83476,2068,5,0,5,C,29.03452880327256
71634,2068,3,1,4,D,28.84749187969752
20332,2068,4,0,4,D,28.83256255320352
135084,2068,2,2,4,J,28.62816340279613
170473,2068,6,2,8,Q,28.93211600242152
113404,2067,6,2,8,M,29.326840994169007
131473,2067,7,2,9,J,29.105528927624505
140214,2068,3,3,6,P,28.93611905803613
122579,2068,2,3,5,E,29.177695258159407
16584,2068,2,2,4,P,28.454447949331907
114946,2068,7,0,7,P,28.83792090415652
93304,2068,6,2,8,Q,29.10070493544141
21746,2067,6,2,8,E,29.216448553713928
165286,2067,3,2,5,A,29.177163647518004
115528,2067,2,0,2,D,29.448090327119225
157972,2067,8,2,10,A,29.22558563378044
96006,2067,7,2,9,Q,28.878016324532755
118633,2068,2,1,3,K,28.87808424602064
181159,2068,3,3,6,Q,28.68928222661784
144790,2067,5,4,9,N,29.270430061675988
134499,2067,6,2,8,Q,29.000070640432178
137289,2067,2,2,4,P,29.199307417797183
92950,2067,4,0,4,D,29.30249051088127
55945,2067,5,0,5,Q,28.91482844824391
143123,2067,6,1,7,M,29.158310342004704
78471,2067,3,1,4,Q,29.40143534022528
109386,2067,2,3,5,N,29.38317649998517
138203,2067,7,1,8,E,29.56873594706392
53832,2068,3,1,4,Q,29.240316157422157
108497,2067,9,0,9,P,28.95028613233653
124712,2067,2,0,2,K,29.32100373720837
134975,2067,1,3,4,E,29.088632801199218
25982,2068,2,2,4,A,28.679181606339995
69331,2067,5,2,7,E,29.41734357225923
66678,2067,6,2,8,Q,29.4046400890936
158176,2067,7,2,9,E,29.238308541246912
26254,2068,9,1,10,D,28.84644459425696
76391,2068,3,3,6,M,28.90924077733783
144554,2068,4,2,6,M,28.778738299852044
108749,2067,5,2,7,E,29.23918802835185
30635,2068,4,3,7,Q,28.57955378501677
51259,2067,5,2,7,Q,29.386883992890283
176835,2068,8,0,8,E,28.88234212830126
101399,2067,4,2,6,Q,29.14664365562428
27077,2068,2,2,4,J,28.680540131526683
123221,2068,5,1,6,E,28.913159427464866
135738,2067,4,2,6,J,28.97150086376017
86313,2068,6,0,6,E,28.48151650051188
134647,2067,6,2,8,K,29.22623446889865
38168,2068,1,2,3,E,28.66957744481652
129282,2068,5,0,5,M,28.731612129520844
135211,2067,4,0,4,E,29.60344915813324
41239,2068,3,1,4,K,28.904935146400167
144876,2068,10,1,11,N,29.17821076282065
158844,2068,3,1,4,E,28.667509217407726
84102,2067,4,5,9,S,28.963232307274545
51468,2068,6,0,6,N,28.51817630443824
68668,2067,5,1,6,D,29.43733912204253
136104,2068,5,3,8,P,28.832069053578508
56460,2067,6,2,8,M,29.147808837802152
111978,2067,7,1,8,N,29.06749877834028
136933,2068,4,1,5,Q,28.56508927665758
51574,2068,7,2,9,E,28.902494047598587
130201,2067,3,1,4,E,28.84749089998818
118368,2068,15,6,21,P,28.836318456852418
72034,2067,4,2,6,J,29.543630129852698
131941,2067,4,2,6,H,29.26530865629619
77341,2067,4,2,6,E,29.11505100470001
169298,2068,6,1,7,D,29.105328125271125
169619,2067,4,2,6,N,29.68833551163717
135452,2068,9,2,11,E,28.62185370662315
135867,2068,4,2,6,M,29.14417821843616
100167,2068,6,0,6,E,29.15332324434446
95045,2068,10,1,11,Q,29.180400255673035
92511,2068,4,2,6,F,28.787080551144587
70693,2068,6,2,8,M,28.970788235713105
169852,2068,1,3,4,Q,28.865176711935327
69006,2068,5,5,10,S,28.696291624975668
32914,2067,5,1,6,E,29.207532788708438
17961,2068,6,2,8,A,29.04755780776076
37075,2067,5,1,6,E,29.068241450051858
77403,2067,2,2,4,J,29.22958036479902
172971,2067,3,1,4,N,29.169494326956656
77698,2068,3,2,5,E,28.84260361003344
28091,2068,2,0,2,Q,28.75560567823519
103590,2067,3,2,5,N,29.27965263361228
29620,2067,3,1,4,Q,29.16783780550005
165380,2067,6,2,8,N,28.96060468548808
72963,2068,6,2,8,J,28.837823087245944
185037,2068,11,4,15,P,28.89660323093999
30011,2068,9,4,13,I,28.72262290417032
148777,2068,6,2,8,M,28.78794879437493
30313,2068,17,2,19,E,28.65921027990733
115259,2068,7,0,7,M,29.12043824140788
96120,2068,5,1,6,S,28.964483798389995
44411,2068,5,2,7,N,28.833183441776917
37229,2068,3,4,7,P,28.91241088802276
120000,2068,6,2,8,E,28.83761624383365
103301,2068,7,0,7,J,28.84598405561086
167237,2067,5,3,8,J,28.98338528241424
98636,2067,5,1,6,J,29.33419077779412
161632,2067,2,1,3,E,29.54564271499476
83126,2068,2,2,4,E,29.11837059085027
136108,2068,3,3,6,E,29.458531106765687
142524,2068,6,2,8,P,28.706631845938183
159830,2067,3,2,5,S,29.06197384839385
68941,2067,8,4,12,E,29.258104279919294
23791,2067,6,2,8,Q,28.976745752281865
41250,2067,4,1,5,Q,29.095895645457844
139768,2067,5,0,5,Q,29.23115469028489
122065,2067,5,1,6,Q,28.52935415429608
139057,2067,5,1,6,P,29.261387164933765
94035,2068,5,2,7,E,28.6830046611414
21737,2068,7,1,8,E,28.935644172783785
171099,2067,7,1,8,E,29.08034339174942
141155,2067,5,2,7,E,29.02395675757816
40011,2067,4,2,6,E,29.21105299019875
38132,2068,2,3,5,J,29.020983851231552
73957,2067,7,0,7,N,29.104583346472705
60012,2068,5,1,6,E,29.30583832718368
132642,2067,5,2,7,N,29.402529857589872
112824,2068,6,1,7,E,28.648773395559772
141824,2067,5,1,6,M,29.10836738717501
21104,2068,2,3,5,Q,28.97109460950158
129008,2068,4,1,5,E,28.70082227889333
62187,2068,4,2,6,Q,29.03090239028366
64762,2067,5,2,7,N,29.354568201941003
29693,2067,4,1,5,K,29.491959441363505
121512,2067,5,3,8,E,29.006881652802846
94160,2068,9,1,10,Q,28.911842717800692
117581,2068,12,1,13,N,28.978491547217285
45018,2067,2,1,3,E,29.08220555034406
177638,2068,6,0,6,Q,28.970764021370027
113956,2068,5,0,5,E,28.919563181732507
158765,2068,3,2,5,D,28.923530758862437
81666,2068,3,0,3,A,28.979295629864247
41635,2068,3,2,5,C,28.737727446367167
113202,2067,5,3,8,L,29.26774697640445
182284,2068,7,2,9,E,28.981679202673572
144957,2067,4,0,4,M,29.09462269274423
171219,2067,3,2,5,A,29.01033380984072
139382,2068,6,0,6,E,28.78655112946443
21553,2067,6,0,6,M,29.030034367452792
89253,2067,5,2,7,J,29.220184763869003
18402,2068,2,4,6,Q,28.7494869118502
82547,2068,7,3,10,A,28.62345366228341
101750,2067,2,3,5,J,29.134028759680607
32825,2067,3,2,5,E,29.372094323438358
53905,2068,6,1,7,N,28.843159298576985
21018,2068,7,1,8,N,28.746979365479884
124428,2067,5,1,6,E,29.16671673864774
93827,2068,6,2,8,J,29.102389805688947
46247,2068,8,2,10,A,28.78667831805251
159457,2067,9,2,11,H,29.17206757072877
102436,2067,4,4,8,K,29.25106278055018
125220,2068,3,2,5,P,28.85389334156362
123747,2068,4,0,4,N,28.96555548718356
71751,2068,5,1,6,E,29.009700923803376
28780,2067,5,1,6,E,29.543284212342527
106422,2068,6,0,6,J,28.74361933938241
163392,2068,7,1,8,N,29.087984833857583
17694,2067,1,1,2,N,29.281590866766376
138291,2068,2,0,2,N,28.62234198602873
96620,2068,0,3,3,S,28.775753151866105
138838,2068,1,1,2,N,29.003526835163683
25760,2068,15,0,15,P,28.602626833329687
114402,2068,3,1,4,J,28.991190244833035
78768,2067,6,2,8,K,29.34941871381305
69447,2067,3,0,3,D,29.492829784504487
178589,2067,5,2,7,M,29.053347100885805
68889,2068,6,1,7,E,29.064074546640523
38526,2068,6,2,8,K,29.09092823119593
101152,2067,4,2,6,P,28.841128648972106
74860,2067,5,0,5,N,29.15986164650341
165336,2068,4,1,5,H,28.870080870706374
110425,2067,3,0,3,K,29.17363835858325
19835,2067,4,1,5,P,29.391618239519747
170933,2068,5,2,7,N,28.33797921477853
82968,2068,3,1,4,D,28.87003506740264
96351,2068,7,1,8,J,28.976118322911464
111794,2068,1,2,3,J,28.68120740672783
135031,2067,10,2,12,J,29.274520412136923
147171,2067,8,2,10,N,29.172485332762896
21805,2067,5,3,8,M,29.00856844347755
51198,2068,6,1,7,A,28.57462749900435
53298,2068,8,4,12,H,29.119860565029363
40597,2068,2,1,3,D,29.00726462631287
83105,2068,2,1,3,F,28.772839110094363
100321,2068,5,2,7,N,29.15804372301608
59059,2067,6,2,8,D,29.3440798283676
65632,2067,8,1,9,E,29.036117506873243
86968,2068,6,2,8,E,28.944430843497525
60124,2068,5,2,7,M,28.72040893706093
28987,2068,6,1,7,N,29.22522198069335
144676,2068,6,2,8,F,28.774370091586476
26118,2068,5,3,8,F,28.84094804032582
123658,2068,5,2,7,K,28.825699930819425
107339,2068,6,0,6,A,28.998064501743094
136607,2067,4,3,7,D,29.1865698744695
96698,2067,3,1,4,Q,29.135973090739373
67827,2067,10,3,13,M,29.05382781047351
130315,2068,7,1,8,D,29.10955523483728
23815,2067,3,1,4,Q,29.14789159976468
93896,2067,5,1,6,E,29.18158351856302
41730,2068,3,2,5,N,29.099476776095702
120404,2067,5,0,5,M,29.40327095834608
167187,2068,5,1,6,M,29.02956193433557
173417,2067,4,1,5,A,29.297010822737747
129471,2068,9,2,11,N,29.00328330019567
96142,2068,7,3,10,Q,28.56806990795065
124757,2067,4,2,6,Q,29.04773102638736
27570,2068,7,0,7,N,28.77069059539035
134848,2068,6,1,7,M,28.625374715484213
109298,2068,7,3,10,Q,29.059450259717472
97457,2068,2,1,3,Q,28.812282098468916
110783,2067,3,0,3,N,29.03314878673609
173585,2068,4,1,5,D,28.975581037065744
130093,2067,4,1,5,N,29.283275377120965
63120,2068,7,0,7,E,29.020169714354363
170090,2067,6,1,7,N,29.242465867759257
117903,2067,4,1,5,E,29.38878501969121
46756,2068,4,2,6,K,28.84945205239144
111434,2067,7,0,7,J,29.015307844655336
134805,2067,3,1,4,N,29.153762683380947
145439,2068,6,2,8,E,28.634561831797896
77688,2068,7,1,8,Q,28.61343484751247
120455,2067,6,4,10,E,29.020162508451616
174443,2068,2,2,4,N,29.277132400012665
82203,2067,2,3,5,E,29.063038634689025
177684,2068,4,4,8,E,28.931234293042525
37406,2067,5,2,7,N,29.26157784254248
94007,2067,9,2,11,Q,29.338299376284542
88796,2067,3,1,4,N,29.541607846381265
125663,2068,4,0,4,E,28.786974213087973
77211,2067,1,1,2,N,28.98980940716856
157559,2067,3,3,6,E,29.10780608507492
20209,2067,5,1,6,N,29.17812984663048
130328,2067,5,0,5,K,29.235287106801326
163323,2067,5,2,7,H,29.064064330696844
100692,2067,2,2,4,D,29.36719861076452
84705,2067,2,2,4,K,29.08592783463393
163964,2068,3,2,5,N,28.98862120144953
25100,2067,5,2,7,J,29.08747057673714
163438,2068,6,0,6,S,28.94833326576227
54405,2068,6,3,9,M,28.88230331427012
171023,2068,4,0,4,D,28.85429152297415
72487,2067,1,2,3,P,29.17849217576437
36910,2067,0,10,10,M,29.20202314988125
36644,2068,3,1,4,E,28.63471584292616
134648,2068,5,2,7,G,28.753271150706112
50676,2068,7,0,7,E,28.93699679048693
49624,2068,6,0,6,N,28.706262451470057
41570,2068,4,2,6,J,28.809217986718803
82336,2067,8,3,11,C,29.29901330693775
16397,2068,5,2,7,Q,28.92784693084039
68870,2068,6,0,6,J,28.76159084831081
156099,2067,5,1,6,A,29.259171595391678
129726,2068,6,1,7,A,28.937072412520397
82755,2067,10,0,10,H,29.239349151997605
67261,2068,3,3,6,E,28.85284036125913
57443,2068,3,0,3,J,28.620616934389684
185010,2068,14,2,16,P,28.60552305858204
145541,2067,4,2,6,M,29.28202517970931
92090,2068,1,2,3,N,29.107546971814003
173889,2068,4,3,7,D,28.76287966074205
161291,2067,4,1,5,A,29.16550143740552
86848,2068,5,1,6,Q,28.962359297432023
167492,2068,4,1,5,N,28.83299967453204
109150,2068,3,1,4,E,29.08974159621681
22321,2068,4,0,4,P,28.835523679510377
110273,2068,16,4,20,H,28.69566629625185
38201,2068,5,2,7,P,28.760541099744668
57086,2068,5,2,7,M,29.00889458118372
86763,2068,5,2,7,D,28.835265135142468
88894,2067,5,0,5,E,29.41406851076115
149330,2068,5,0,5,J,29.06411921114476
109215,2068,5,0,5,E,28.625241891838783
66229,2068,6,2,8,E,29.028638858446985
166861,2068,7,1,8,S,28.81641947011102
178978,2068,4,3,7,E,28.6320823290108
159243,2068,7,0,7,Q,29.223850978916712
164813,2068,6,1,7,N,29.088771873000493
71363,2068,6,0,6,J,28.73395018541361
122876,2068,3,0,3,M,28.838426573288736
116451,2067,10,2,12,Q,29.310464658426717
144249,2067,5,1,6,M,29.357220861880545
90959,2068,5,2,7,M,28.50719198658316
71358,2067,6,0,6,P,29.24150620461792
55122,2067,6,2,8,A,29.51171706161797
101533,2068,2,0,2,N,28.89896108786
63634,2068,5,0,5,D,28.56510520536003
18552,2067,1,2,3,N,29.06777306312557
24722,2067,9,0,9,D,29.0775055591412
72514,2068,6,0,6,A,29.028720844090017
88921,2068,5,2,7,E,28.897096252813668
144921,2068,8,0,8,A,28.9332143065872
75611,2068,3,0,3,E,29.04957384695673
71331,2067,10,1,11,N,29.249980964028754
167358,2067,7,2,9,Q,29.358497362678403
23968,2067,3,1,4,P,29.26354603951916
149562,2068,3,2,5,C,28.5711225492775
79160,2068,6,2,8,N,28.91104055689503
31027,2068,2,1,3,Q,28.517475248963247
92612,2068,7,2,9,N,28.63222648145871
109690,2068,2,0,2,N,29.16517108357369
110030,2068,2,1,3,N,28.694422899536026
155942,2068,6,2,8,N,28.790237551962825
90316,2067,6,0,6,H,28.80761844970271
45194,2067,5,0,5,Q,29.3959225620832
166689,2068,6,2,8,E,28.853172783038307
144637,2068,2,3,5,M,28.52251151196501
110311,2067,5,1,6,P,29.27137477437883
63335,2067,9,1,10,Q,29.20302477087933
94580,2068,12,6,18,J,28.918818597568315
24520,2067,3,2,5,E,29.18062534237288
29258,2067,4,1,5,E,29.196123437352227
34576,2068,3,1,4,L,29.075315678315384
137946,2067,2,0,2,Q,29.04603845905224
70460,2068,4,2,6,Q,28.596098603922748
161555,2067,5,3,8,E,29.36188958465212
29084,2067,4,1,5,E,29.104293286704955
147876,2068,6,0,6,N,29.07816917272833
54704,2068,5,3,8,M,28.6210992741753
173424,2067,7,1,8,E,29.02962891590384
58812,2067,2,1,3,E,29.07925000418281
143271,2068,4,1,5,N,28.70750358914044
112568,2067,5,2,7,N,29.441190266279108
78889,2068,7,0,7,F,28.85779329246287
117441,2067,7,1,8,P,29.653614284357168
82903,2067,5,2,7,S,29.09392194736225
16702,2067,3,2,5,D,29.16633821567813
24341,2068,4,1,5,D,29.346966295473425
145740,2068,1,3,4,E,28.966317414003957
60039,2067,5,1,6,C,29.03437498646889
132717,2068,4,2,6,E,28.67679597178088
183502,2068,3,0,3,N,28.914503801138828
49306,2067,3,2,5,S,28.852178377962712
67194,2068,5,0,5,M,28.79637194248958
145498,2068,2,0,2,K,28.83483038429372
142781,2067,5,0,5,M,29.29638696196329
139893,2067,2,2,4,D,29.40548308448558
42466,2068,3,5,8,P,28.7940960469346
144513,2068,4,0,4,G,28.94210484053902
110849,2068,4,1,5,K,28.794790108658848
170629,2068,3,0,3,P,29.09203040342287
65473,2067,2,0,2,N,29.247372756250783
46210,2068,5,2,7,A,28.923388754827236
41619,2068,3,1,4,A,28.492501416222638
182769,2068,6,0,6,Q,28.737615790703764
87767,2068,3,2,5,L,29.124835627245915
122786,2068,3,0,3,E,28.835066926192468
100157,2067,2,1,3,N,29.199770077908603
109720,2068,5,0,5,M,28.88371359415047
88175,2067,6,0,6,E,29.266262739610987
75393,2068,6,1,7,J,28.59503173873908
127432,2067,3,3,6,E,29.11696670868021
88543,2067,3,2,5,K,28.996103638923024
84070,2067,10,3,13,E,29.476757672701577
166789,2068,6,2,8,M,29.263445059310797
55799,2067,7,1,8,M,29.50773274668544
148490,2067,3,1,4,S,29.29453478608188
19557,2068,5,0,5,P,28.80740433538845
128851,2068,6,2,8,P,28.791953363009373
114137,2067,3,1,4,E,28.93741240422677
174064,2068,2,1,3,Q,29.113572066428667
115153,2068,6,3,9,J,28.511652442946
18967,2068,6,1,7,E,28.6692690580626
96022,2067,2,0,2,K,29.383747426290128
107898,2068,5,2,7,N,28.70353243846773
143982,2067,3,1,4,P,29.463215450104848
74012,2068,4,1,5,E,29.05195616523199
167633,2067,7,1,8,Q,29.26465025520996
106628,2068,7,1,8,E,28.774720299653257
120041,2067,4,0,4,E,29.242850126165912
108175,2067,6,0,6,E,29.142809325025183
25137,2068,1,3,4,N,29.081108195492718
67479,2067,5,3,8,E,28.973712107578784
161790,2068,1,3,4,S,28.891174817353377
174686,2067,4,2,6,S,29.094913012456484
24433,2067,7,0,7,J,29.30888776436328
84989,2068,4,1,5,D,28.675830075879983
168251,2068,4,1,5,J,29.0477942824792
139897,2067,5,2,7,N,29.184790299612825
150206,2068,6,0,6,M,28.88038727138356
160590,2067,15,4,19,E,29.299719891865237
115044,2067,3,0,3,K,28.98411679549834
19861,2068,4,2,6,P,28.73484455153527
86306,2068,4,1,5,S,28.74169717986215
69315,2068,4,0,4,P,29.092183216583265
130231,2068,2,0,2,M,28.77501140255749
20693,2067,7,0,7,L,29.041599888152803
147649,2068,3,2,5,J,29.387244184088075
72070,2067,3,1,4,E,29.585469288561477
17999,2067,4,3,7,E,29.449966512113196
78636,2068,8,0,8,M,28.420683873080925
41815,2067,6,1,7,N,29.39560584246156
178503,2068,6,2,8,E,28.79259563040597
64317,2068,7,0,7,D,29.03703602250336
121315,2068,2,1,3,E,29.116534723033208
160209,2067,3,1,4,M,29.282184132503648
28543,2067,3,1,4,D,29.062752419572984
95152,2067,2,0,2,N,29.079082254880703
120360,2068,4,1,5,K,28.873751952864243
39234,2067,4,0,4,E,29.430130315040177
102250,2067,2,0,2,S,28.999328127251207
50833,2067,3,1,4,E,29.187723703904155
164866,2068,5,0,5,K,29.27524967298487
91574,2067,9,2,11,N,29.004822690454294
96703,2067,7,3,10,N,28.768128240672336
157644,2067,9,1,10,Q,29.07504343218441
134932,2067,4,3,7,N,29.51955244518621
19619,2067,6,2,8,D,28.938061127647973
25883,2068,4,3,7,Q,29.113811275246725
170119,2067,5,2,7,J,28.786941725793845
166618,2067,4,2,6,P,29.148651732906536
46374,2068,1,2,3,Q,28.717586305576575
125048,2067,5,0,5,E,28.92913636957075
95534,2068,4,3,7,N,28.79637820436506
78407,2067,5,0,5,M,29.320522339674778
21593,2068,7,0,7,E,28.938555139321394
33728,2068,2,2,4,E,28.94739535118831
65932,2068,6,3,9,S,28.92409067772008
162404,2067,2,2,4,S,29.231414814370023
98075,2068,3,1,4,Q,28.621129446956623
161825,2068,3,1,4,N,28.873110116304392
21455,2067,7,0,7,M,29.430501166220804
93408,2068,6,2,8,E,28.677891510909237
157045,2067,5,1,6,D,29.290194564616648
68665,2067,5,1,6,P,29.46271038920821
147561,2067,4,1,5,M,29.15198346022331
136768,2067,5,2,7,J,29.274568351570537
162529,2067,6,1,7,N,29.22920964998422
17106,2067,7,2,9,P,29.39434365459663
113569,2067,2,0,2,M,28.979083114279
109901,2068,1,3,4,J,28.87599268482283
118368,2067,6,4,10,P,29.19890948185921
39145,2068,6,2,8,K,28.71500691199313
128555,2067,6,3,9,E,28.920457098250687
74400,2067,5,1,6,A,29.471052299545672
118555,2067,3,1,4,D,29.06115919722408
84131,2068,6,1,7,M,28.77489607428208
113095,2068,4,2,6,E,28.53221231141497
147305,2068,5,2,7,M,28.83094515182005
39632,2068,5,1,6,P,28.867141584227934
27030,2068,4,3,7,E,29.00045195149112
39094,2068,3,2,5,E,29.355926372366863
165366,2067,5,1,6,M,29.109642432045376
66310,2067,4,0,4,D,29.17643035805141
97192,2067,2,2,4,A,29.42559137192067
85078,2067,6,2,8,E,29.07236227386559
55345,2068,6,2,8,J,28.988343806012757
85599,2067,6,0,6,D,29.25804321713525
158961,2068,5,3,8,J,28.812882595068693
167189,2067,2,1,3,E,29.066277616107477
146705,2067,3,2,5,Q,29.23308161447376
86220,2067,9,1,10,J,29.034808802740223
52413,2067,3,2,5,P,29.410894057453323
155935,2067,2,1,3,N,29.010383554099125
81409,2068,2,2,4,N,28.724667600738144
117585,2067,4,1,5,P,28.95282905017692
57245,2068,4,3,7,N,29.280271861139
25383,2067,10,1,11,D,28.85854804415896
74151,2068,2,1,3,J,29.08404291771206
138300,2068,5,0,5,P,29.203561452318706
137769,2068,6,1,7,M,29.19086095268431
181908,2068,6,2,8,D,28.725250895422626
48693,2067,6,1,7,N,29.49827001921064
22516,2067,6,0,6,M,28.87639774443961
54456,2067,6,3,9,Q,29.010675895823123
93925,2067,2,0,2,N,29.573473706935008
22571,2068,3,3,6,M,29.014477584245373
81477,2068,5,1,6,D,28.666790436149395
55799,2068,5,2,7,M,28.66739504614622
71037,2067,3,0,3,Q,29.141431054237444
147925,2067,4,0,4,N,28.95877924320016
72867,2068,3,1,4,M,28.64255808764012
69238,2067,6,0,6,E,29.16731436085594
144588,2068,2,2,4,M,28.84467511786919
157300,2067,3,2,5,L,29.17906934311995
96832,2067,4,3,7,J,29.186654424203105
106889,2067,3,2,5,N,29.104679460944304
110991,2068,3,1,4,E,28.889181351186025
143565,2068,6,2,8,D,29.31562948578889
114467,2068,10,2,12,E,28.580418051088454
89763,2067,2,0,2,N,29.30035283835752
19059,2067,2,2,4,A,29.37395047812428
130730,2067,4,0,4,E,29.31702036747174
66670,2068,4,2,6,N,29.192506281728207
150280,2068,6,0,6,Q,29.00447929607357
101130,2067,5,2,7,J,29.70066280496672
70148,2068,2,3,5,E,28.94627272823236
180169,2067,4,2,6,D,29.047188393381933
120584,2067,6,0,6,N,28.79355924660186
45690,2068,14,4,18,A,28.49701754327971
20205,2067,4,2,6,E,29.30974406423422
138658,2068,5,3,8,J,28.37015220626906
22214,2067,6,2,8,N,29.27652020781377
18182,2067,3,3,6,J,29.341499532826383
148268,2067,7,1,8,E,29.55788471529768
81766,2067,9,3,12,D,29.02344073581424
96899,2068,7,1,8,M,28.87835740617473
110912,2068,5,3,8,E,29.00970546514226
97071,2067,4,2,6,J,29.218197483765607
19506,2067,4,0,4,F,29.458598739078926
159356,2067,3,1,4,E,29.04315884667785
93601,2068,3,0,3,N,28.628406801341423
83126,2067,5,1,6,E,28.770543683468315
41882,2067,4,3,7,E,29.2330428336528
25825,2067,6,1,7,D,29.00198651795752
64804,2068,3,0,3,Q,28.92660623104402
147670,2067,4,1,5,K,28.62358282391963
79244,2068,6,0,6,P,29.022185807696257
21056,2067,5,2,7,E,29.16215761570509
120984,2068,4,0,4,P,29.083054120597957
24979,2067,2,1,3,D,28.939443762238472
106900,2068,3,1,4,S,28.737782485338133
137173,2067,5,2,7,P,29.37632458274146
22129,2068,5,2,7,M,28.910022806124008
86801,2067,4,0,4,P,29.00279594175274
47141,2067,5,2,7,E,29.213045814137928
174571,2068,5,1,6,R,29.16344130017545
44944,2068,2,1,3,N,28.759321039348723
99125,2067,3,0,3,A,29.232718762799223
32409,2068,2,0,2,E,28.82243653768328
120653,2067,2,2,4,J,29.240300335487643
137893,2067,4,2,6,M,29.413830861212464
159436,2068,10,7,17,L,28.6908506533931
146233,2067,2,2,4,Q,29.08084645739828
112111,2067,4,1,5,K,29.21736495887425
158736,2067,4,0,4,Q,29.26419687039143
107303,2067,6,1,7,E,28.82931928520165
73776,2067,4,1,5,E,29.06945804662845
66388,2067,12,3,15,E,29.089190518761207
97863,2068,3,2,5,M,29.064967099741075
135763,2068,4,3,7,P,28.87020652709309
174733,2068,5,0,5,Q,28.705072019874585
141903,2068,6,2,8,N,29.053335075782652
45609,2068,4,2,6,Q,29.001263983594622
69084,2068,4,3,7,F,28.693696027242986
77838,2068,6,0,6,K,28.861852990928032
98762,2068,5,1,6,K,28.54494593807616
46389,2067,7,2,9,D,29.08938364768173
124920,2068,5,3,8,M,28.573118347465904
109117,2067,6,1,7,P,29.421868418903152
51580,2067,3,0,3,K,29.483472344383937
74304,2068,4,0,4,P,28.81827326074583
91574,2068,13,3,16,N,29.10788475370162
48344,2068,2,2,4,D,28.73637498904925
157109,2068,9,2,11,N,28.798474455475947
120700,2068,7,1,8,J,28.98570695335704
180028,2068,4,3,7,M,29.045278481144027
116618,2068,7,2,9,J,29.141063879266188
71871,2067,6,2,8,E,28.96958130020068
176731,2067,4,0,4,R,29.383448572944307
129919,2068,5,3,8,E,29.058588312667187
124222,2068,3,2,5,P,28.50429106198015
115908,2067,6,4,10,L,29.096920871504352
164231,2067,4,1,5,S,28.90494825301531
158697,2067,6,0,6,E,29.63257976579488
31588,2068,2,1,3,M,28.915426376772224
65934,2068,3,3,6,E,28.665126623574984
39422,2068,7,2,9,D,28.80887196805224
96076,2068,3,0,3,Q,28.63697518629439
35287,2068,3,1,4,N,28.90928032186952
132973,2068,4,2,6,E,28.872371789079423
22071,2067,8,1,9,M,29.082288758900223
147860,2067,3,1,4,M,29.163438660144347
170749,2067,5,0,5,N,28.995789263622548
140794,2067,6,2,8,E,29.03436423157827
78611,2067,4,2,6,D,29.087827438971644
64147,2068,10,1,11,E,28.965103952601314
117668,2067,4,2,6,J,29.3122862083355
109545,2067,4,1,5,J,29.34631269668357
105924,2067,4,2,6,E,29.51263848673637
169290,2068,13,2,15,Q,29.073436712817188
32511,2067,5,0,5,Q,29.194689196244976
86295,2068,4,0,4,P,28.7485686969054
115945,2068,1,4,5,M,29.059570693942906
132241,2067,8,0,8,P,29.01776758479459
146930,2068,8,1,9,N,28.94496619593625
77538,2067,4,2,6,Q,29.318672983645843
175335,2067,6,1,7,N,29.187108292326062
138433,2068,6,3,9,M,28.949026918967338
20478,2068,6,2,8,M,28.865069982604968
83648,2068,4,1,5,D,28.92694203723122
143783,2068,7,2,9,P,28.853518950204062
105799,2068,3,2,5,E,28.864152155386844
62805,2067,5,2,7,D,29.12293880067605
115091,2068,3,3,6,E,28.787359675225623
52589,2068,2,1,3,S,28.647591154984436
167033,2068,4,2,6,A,28.891907590103663
77525,2068,3,0,3,M,28.67489580250192
149114,2068,8,2,10,M,29.01012657867673
183610,2068,5,1,6,E,28.905354429051325
84195,2067,2,3,5,N,29.12052823230878
122040,2068,5,2,7,J,29.052421050715093
27094,2067,4,0,4,K,29.29563441939802
111684,2068,6,1,7,J,28.48674953374585
96968,2067,5,2,7,J,29.109851175516106
93227,2068,5,3,8,M,28.97913581025501
170211,2068,4,2,6,D,29.04998473500225
175603,2068,1,1,2,Q,28.798321458643297
102833,2068,2,1,3,P,29.17617996989789
142323,2068,5,2,7,M,28.673041654875774
41130,2067,5,3,8,N,28.88301256922914
166034,2068,5,0,5,K,29.037830321315216
131232,2068,2,2,4,N,28.784052908427835
65001,2068,3,1,4,D,28.976008506308947
38230,2068,5,0,5,P,29.02661359173832
82781,2068,1,1,2,N,28.99055541080653
127941,2067,4,1,5,P,29.171785441276832
149525,2068,7,1,8,P,29.01386155120006
167425,2067,6,3,9,M,29.77174464785572
131391,2068,3,2,5,J,29.23362676409696
169579,2067,7,1,8,D,29.099548685945805
143417,2067,6,2,8,P,29.30257200224592
118690,2067,5,3,8,N,29.39475032161249
139757,2067,3,3,6,M,29.238626502297677
47591,2067,6,1,7,E,29.17042378585474
160179,2068,3,3,6,F,28.778922125480936
31740,2068,7,4,11,S,28.780886753641006
99179,2068,10,1,11,E,28.94520383300133
161338,2068,5,2,7,H,28.922374391927097
66503,2067,2,1,3,M,29.606856831506104
122519,2067,2,2,4,N,29.246183306850355
59593,2068,7,0,7,D,28.6220562529952
141411,2068,16,5,21,E,28.745405039925117
59679,2068,6,1,7,N,28.95860778274495
115818,2068,5,3,8,J,29.23013419943191
91612,2067,7,2,9,N,29.37766230503844
42812,2068,5,1,6,N,29.129013948189964
137357,2068,6,1,7,Q,28.99342209619864
89048,2068,1,2,3,Q,28.75888768520463
139183,2068,5,2,7,P,28.869539421905277
61121,2067,3,2,5,N,29.161620754123376
105349,2067,5,2,7,J,29.14444392897097
41529,2068,7,2,9,D,29.056451743822297
162529,2068,2,0,2,N,29.2731918775574
61776,2067,2,3,5,N,29.317217138506223
130468,2067,2,2,4,M,29.35634468784792
59295,2067,5,2,7,E,29.090908456032384
18046,2067,8,1,9,E,29.22583082921427
53700,2067,6,2,8,E,28.87311396280103
119677,2068,5,1,6,E,28.646925488072995
145142,2067,3,0,3,P,29.20424648387012
163509,2068,3,1,4,M,28.77156668380267
165441,2068,4,0,4,H,28.54547941316602
62400,2068,2,2,4,N,28.82780958470605
81202,2068,2,3,5,D,28.95968240141535
81816,2067,3,2,5,J,29.117427631309894
118427,2068,10,3,13,Q,28.973234801420755
144275,2068,6,0,6,P,28.94245447282948
104085,2067,12,1,13,N,29.27098054057046
77319,2067,6,0,6,E,28.999063018335047
20718,2068,3,1,4,D,28.63546422996209
158587,2067,10,1,11,Q,29.163313898653627
159607,2067,5,0,5,E,29.174737143676428
48740,2067,7,2,9,E,29.01792143182772
90135,2068,6,1,7,D,28.63257480684941
41959,2067,5,1,6,N,29.37956701180129
34299,2068,8,1,9,K,28.62668858069355
109948,2067,2,3,5,J,29.1980665454571
52311,2067,7,1,8,E,29.456134456549304
151059,2068,4,2,6,M,29.042029033041267
18823,2067,6,1,7,C,29.20048935170247
127688,2068,5,1,6,J,29.113437565117657
77252,2067,5,1,6,M,29.32657406441177
179634,2068,4,1,5,D,28.907369293071483
21883,2067,3,4,7,S,29.36697617336601
45008,2068,5,0,5,Q,28.999499106209317
106272,2067,3,1,4,Q,29.279503260139364
165087,2068,2,4,6,S,29.19464805995362
96069,2068,2,3,5,D,28.890728505568607
49439,2068,6,1,7,E,28.84099486611184
176101,2068,6,0,6,Q,29.050023002088444
25834,2067,6,2,8,Q,29.031327257182404
96706,2068,4,2,6,N,28.7018261156734
98762,2067,4,2,6,K,28.837992922808976
96006,2068,5,1,6,Q,29.02755978786583
95525,2067,3,4,7,N,29.129636560735147
57608,2068,3,2,5,M,28.823619544508237
37963,2067,3,2,5,P,29.208344319144764
111547,2068,5,2,7,E,28.830696468319164
117750,2068,3,0,3,E,28.545054484214216
143806,2068,5,0,5,Q,28.716831022252407
74837,2068,5,2,7,J,28.879731705929508
25865,2067,8,0,8,Q,29.07423430896052
102863,2067,5,0,5,S,29.4938255898716
64057,2068,4,0,4,E,28.991253991885216
21100,2067,4,1,5,E,29.006711204506704
93881,2068,6,1,7,N,29.02873466290289
132988,2068,5,1,6,J,28.754235466467424
68346,2067,6,5,11,I,29.22321142395001
56122,2067,8,0,8,P,29.03858085889836
89185,2067,2,1,3,Q,29.178553366282426
101413,2067,11,2,13,J,29.67646401308154
147685,2067,2,3,5,E,29.09225043229574
23838,2068,5,1,6,K,28.90016601293557
145832,2067,3,3,6,N,29.29479571689905
55524,2068,4,1,5,N,29.049464848532363
135126,2067,2,0,2,E,28.71122483597288
165650,2067,2,3,5,N,29.23530278953905
25631,2068,2,2,4,M,28.89672229399771
20497,2068,5,1,6,P,29.08280754611004
182643,2067,4,2,6,Q,29.202335329897057
145796,2068,3,3,6,M,29.085543332008744
78445,2068,4,2,6,N,29.07872164969667
167033,2067,6,2,8,A,28.93483779109525
130634,2068,3,2,5,E,28.447704471743307
157300,2068,4,1,5,L,28.646623723911077
174442,2068,2,3,5,N,28.84544424591207
49706,2067,1,2,3,S,29.174061915852885
138099,2068,7,2,9,Q,28.506645990641864
65554,2068,6,2,8,M,29.0226787694164
28375,2067,4,2,6,E,29.289590743061144
84413,2067,7,0,7,E,29.17891757855798
64622,2068,2,2,4,E,28.541702440995486
44746,2068,6,3,9,D,28.78515600719028
93140,2067,4,2,6,N,29.312074583952956
165293,2068,4,1,5,M,29.09658355843059
167422,2067,5,0,5,M,29.448855575470503
107064,2068,3,1,4,N,28.89771766433461
137100,2068,4,1,5,P,29.182441923831817
70958,2068,3,2,5,A,28.8334168949717
136276,2067,6,0,6,D,29.28128275866084
61916,2067,7,2,9,E,29.241366635930174
132283,2067,12,2,14,J,29.116601936009705
21479,2067,7,0,7,E,29.27725093234908
150928,2068,6,2,8,M,28.70796965772695
142665,2067,3,1,4,M,28.955140211343625
147900,2068,8,1,9,M,28.83949846032894
21546,2068,6,0,6,P,29.05356387416755
44816,2067,5,0,5,Q,29.258792503887637
95512,2067,4,4,8,Q,29.03429499913428
56347,2068,4,1,5,Q,28.98450043206243
170646,2068,5,2,7,P,28.744289294197017
139813,2067,2,3,5,M,29.269685624368503
136933,2067,4,2,6,Q,29.29051842369459
165696,2067,4,1,5,J,29.19200030007307
172253,2068,3,0,3,Q,29.11289415422648
28651,2067,6,0,6,D,28.876358272541548
158538,2067,6,1,7,S,29.083905468851626
158064,2068,5,2,7,D,28.888628041492105
65751,2068,14,1,15,D,28.61350567481174
37642,2068,3,3,6,C,28.59866504602321
64704,2068,7,1,8,D,29.25096538754398
89726,2067,4,3,7,C,29.09987237450838
88606,2067,6,2,8,P,29.452010093846777
36748,2067,7,0,7,H,29.10503695892638
41906,2068,3,2,5,J,28.93636208655761
24234,2068,4,0,4,N,28.68346970938556
112126,2067,2,2,4,J,28.99674842861157
45907,2068,4,1,5,D,28.853171603041467
21241,2067,3,1,4,N,29.30016206532177
65033,2067,8,2,10,D,29.09108302929355
66422,2068,4,1,5,K,28.749791044829625
23494,2067,7,1,8,D,29.301278465126032
129339,2068,2,0,2,M,28.588933928252327
53493,2067,5,0,5,N,29.07506764941337
124222,2067,5,0,5,P,29.092839387349105
144358,2068,4,0,4,E,28.889362468906192
157020,2068,6,2,8,P,28.696783877337
106188,2068,5,0,5,Q,28.723694383046183
170243,2068,6,0,6,D,28.591827717216766
141696,2067,7,2,9,D,29.11616770550307
97605,2067,4,0,4,C,29.06991996216308
163986,2067,3,1,4,E,29.00021401493538
136297,2067,3,1,4,S,28.94629558815385
109136,2068,0,2,2,M,29.087285603423403
115857,2068,6,2,8,J,28.845746521793554
54732,2067,4,2,6,M,28.951382869022574
163076,2067,7,1,8,Q,29.142286153911076
19385,2068,7,3,10,J,29.113494674507866
137740,2068,4,2,6,P,28.873515413712525
111133,2068,5,1,6,Q,28.968615232241305
179787,2068,5,3,8,N,29.063658720992137
110666,2068,5,0,5,J,28.784236249131546
175238,2068,11,2,13,A,28.960416879924068
49439,2067,5,2,7,E,28.875308736292425
51491,2067,3,2,5,K,28.97809744601392
82707,2067,6,2,8,Q,28.923207932218705
79129,2068,4,1,5,A,28.82227703283115
176397,2067,4,3,7,G,29.052635257602407
175286,2068,6,0,6,M,29.031413659959963
55832,2068,3,2,5,D,28.86426706253711
121974,2068,6,5,11,N,28.849985248256843
144556,2067,2,1,3,M,29.18335399737537
148223,2067,2,2,4,E,29.13759496117385
137290,2068,5,2,7,M,28.764354560094365
103961,2067,3,2,5,N,29.41583381996261
15943,2068,3,3,6,N,28.73965396173223
25876,2067,3,2,5,Q,29.217718660357107
166865,2068,7,0,7,Q,28.99931555668897
117210,2068,3,2,5,N,28.80398009508045
176364,2067,5,0,5,A,29.371982178680582
89113,2067,2,4,6,E,29.139792147453253
23890,2068,6,0,6,Q,29.270012687716363
105147,2067,3,0,3,N,28.880774280097462
114529,2068,4,1,5,M,28.925616911768625
25743,2068,6,3,9,Q,29.012332707206635
54004,2068,6,1,7,E,28.94406919253405
76422,2068,3,3,6,C,28.574678157755688
151234,2068,4,4,8,N,28.6940214233176
111542,2067,5,0,5,E,29.24590795582474
64693,2067,7,3,10,L,29.126708550340584
17502,2067,2,0,2,D,29.38888343896588
164921,2067,5,1,6,E,29.33205330593262
78481,2067,4,0,4,Q,29.237350397115964
26117,2068,6,1,7,E,28.901792506185235
45696,2068,1,3,4,S,28.92896127612333
111439,2067,8,0,8,J,29.243367321927405
160620,2067,4,0,4,A,29.174765728451074
30798,2068,5,2,7,E,29.049217784165688
113972,2067,5,0,5,E,29.19778936246942
18864,2067,3,2,5,E,28.925647144873984
85323,2067,7,1,8,E,29.36073098675805
137824,2067,5,1,6,S,29.429702891908097
102493,2068,3,2,5,A,29.177523433625485
109333,2067,3,2,5,N,28.950769923875026
148576,2068,2,3,5,D,28.945581747866107
85345,2067,6,0,6,E,28.99420216103058
125125,2068,4,3,7,M,28.935494063665693
74146,2067,3,0,3,J,29.329906186504115
16114,2068,2,1,3,S,28.644383124644587
130839,2068,2,3,5,P,28.811526641704283
57187,2068,3,2,5,M,28.839778727492348
118113,2068,1,2,3,J,28.99686794456347
128504,2067,3,1,4,E,29.11624558032719
148077,2068,4,4,8,Q,28.975193315675508
87240,2067,5,2,7,D,29.02316775187479
88175,2068,3,1,4,E,29.08802787030848
93851,2068,4,1,5,A,28.96056166008298
145586,2068,7,2,9,M,28.61663919115992
171936,2067,2,1,3,E,29.151044598615
47484,2067,6,0,6,S,28.85977796919036
124991,2068,8,1,9,J,28.918216354444912
56932,2068,7,2,9,M,28.85024900292331
30451,2068,4,4,8,C,28.641127425462
120173,2067,3,2,5,P,29.072996545036013
116378,2067,3,1,4,D,29.19598899691776
76391,2067,2,1,3,M,29.341253026981047
77058,2068,3,2,5,P,28.86695522760797
73349,2068,3,2,5,M,28.81700505451577
164677,2068,3,1,4,D,29.082942401143487
162358,2067,6,0,6,K,29.13662924818125
137369,2068,4,0,4,M,28.498591921628893
101584,2067,5,0,5,M,29.18203088626409
45864,2067,2,2,4,Q,28.973974131467653
73446,2067,2,3,5,K,29.156479645533334
150137,2068,7,3,10,D,29.1550341496852
101470,2068,6,0,6,K,28.806016459418444
45088,2068,2,0,2,E,28.744913235522677
134591,2068,15,0,15,M,28.926867664804572
145309,2068,5,0,5,M,28.987709867260943
182528,2068,2,1,3,Q,29.002835361441598
173579,2068,4,2,6,N,28.914362701115145
21086,2067,6,0,6,S,29.261119774036395
180429,2068,6,2,8,A,28.98617935680905
142266,2067,6,2,8,Q,29.20620581095769
83448,2067,4,1,5,N,29.494619488449327
75797,2067,2,2,4,Q,29.24533417853344
95389,2067,2,0,2,D,28.941102374489198
106451,2068,8,2,10,E,28.93988742154368
167512,2067,4,1,5,S,28.81736552380746
20899,2068,7,2,9,E,29.181212706754536
127175,2067,5,1,6,M,29.194189492757367
111450,2067,6,2,8,M,29.335107778517276
45217,2067,2,2,4,E,29.16163018987461
109027,2068,6,0,6,E,28.9078645701271
169897,2067,3,2,5,N,28.78800433879228
156099,2068,4,1,5,A,28.825675758146893
173455,2067,6,0,6,E,29.07208594165153
140956,2068,4,2,6,Q,28.655271211059404
156066,2067,4,1,5,N,29.130795748305932
181568,2068,4,2,6,H,28.997729776255
15752,2067,6,2,8,E,29.14438119296057
172580,2068,6,1,7,D,28.87024872573552
74036,2067,6,1,7,N,29.037904846320885
60470,2067,2,0,2,Q,29.103996667099185
157964,2067,4,1,5,Q,28.960441797561657
61998,2068,2,0,2,E,28.75324973432705
95562,2068,7,0,7,D,28.94167592648537
178912,2068,4,2,6,F,29.154453718793064
128766,2068,6,2,8,P,29.15877660930472
37634,2067,3,2,5,E,29.341384917294704
37734,2068,2,2,4,N,29.012690601417464
63309,2067,2,2,4,E,28.992013247237413
58949,2068,14,6,20,M,28.668581239178764
99775,2067,5,2,7,J,28.961605680274246
97255,2068,6,2,8,D,28.859082989947428
181179,2067,6,1,7,Q,29.181871264835333
81766,2068,7,3,10,D,29.33527591883037
113707,2068,5,1,6,J,28.5632185725768
110608,2068,3,2,5,D,28.62722523673906
70383,2067,8,1,9,H,29.52648394015897
81284,2068,5,3,8,P,28.694306599475
167598,2067,5,0,5,M,29.17779034453965
63284,2068,4,1,5,E,28.856790629316446
29651,2067,6,3,9,I,29.369012605942928
156392,2068,3,0,3,Q,28.83915883628853
63961,2068,2,1,3,E,28.949472235489672
98384,2068,28,4,32,E,28.66036998559977
131701,2068,5,3,8,E,29.001325087727
115492,2067,7,0,7,M,29.39101317242695
97557,2068,13,1,14,P,28.72478259335116
37198,2068,7,0,7,E,28.90310445750356
166936,2068,9,1,10,Q,29.089696391592664
125954,2068,3,3,6,N,28.621285236147607
182949,2068,4,0,4,M,28.83739251128169
103510,2067,4,1,5,D,29.20893514660784
99062,2068,5,0,5,J,28.857585010675923
174600,2068,1,3,4,D,28.87542602977941
134654,2068,5,2,7,D,28.85015530442553
62341,2067,2,1,3,Q,29.299174403585337
98420,2067,4,1,5,N,29.06580755568961
151271,2068,5,1,6,J,28.78225380839779
105964,2067,5,2,7,J,29.0484831345246
109078,2068,7,2,9,P,29.06842273616567
67896,2067,2,1,3,E,29.059371099717804
28021,2067,5,1,6,D,29.261384109383386
60249,2068,2,1,3,J,28.80214152990035
24045,2068,4,1,5,H,28.767362707882807
55743,2067,4,2,6,Q,29.16974431326808
123648,2068,3,1,4,P,28.75657459026541
85541,2068,5,1,6,J,28.86797091087227
23810,2068,6,2,8,A,28.934007919307746
17126,2068,1,2,3,P,28.79485338702179
49285,2068,4,2,6,Q,28.973680377727906
20332,2067,4,1,5,D,29.36957534240119
25737,2068,3,1,4,J,28.891732354686205
29098,2067,4,0,4,E,29.17500363029531
74809,2067,5,1,6,Q,29.23984781214092
96968,2068,3,2,5,J,29.20656444230566
169203,2068,5,3,8,A,28.79568021969351
64782,2067,5,0,5,N,29.17863859680736
29572,2067,3,0,3,Q,29.00409667998418
127608,2067,3,0,3,J,28.93415998634346
113226,2068,6,2,8,E,29.015056949604997
121815,2067,2,1,3,K,29.256082308990024
144974,2067,6,1,7,Q,29.54227787595332
99207,2068,5,3,8,N,28.716397238763072
35723,2068,5,1,6,P,28.83934809366172
92380,2067,5,3,8,Q,29.17539358104141
56193,2068,7,1,8,S,28.78153896622715
120314,2068,5,2,7,J,28.706399624276727
53797,2068,6,1,7,D,29.079478746229565
83100,2068,5,2,7,D,28.784063103151198
113624,2068,3,2,5,E,28.59968648043332
44728,2068,4,2,6,M,28.917394863275177
156227,2067,6,0,6,P,29.450369210899257
145252,2067,8,2,10,A,29.01627883209038
67195,2068,6,1,7,J,28.500089431280863
22476,2067,2,2,4,N,29.15848793865344
92720,2068,6,4,10,E,28.9421373978915
84504,2068,2,2,4,D,28.759843906625363
157052,2067,5,0,5,N,29.01726312154941
69608,2068,4,0,4,E,28.965788654834807
69140,2068,3,3,6,E,28.87227918179858
65878,2067,3,0,3,E,29.27854038190898
131478,2067,6,0,6,N,29.419586101549385
136790,2068,5,1,6,D,28.85291475601682
147703,2067,3,2,5,Q,29.07645227960755
145429,2068,1,3,4,J,28.851318690298086
40514,2068,7,2,9,Q,28.43963442740064
121745,2068,12,0,12,H,28.908857457492797
124677,2068,5,0,5,E,28.927134844199497
51403,2068,3,2,5,S,29.158472684475974
115683,2067,4,2,6,J,29.383640885703443
176428,2068,6,0,6,F,29.13050563423507
171004,2067,1,2,3,P,29.166704160610525
146682,2067,3,2,5,D,28.889370032865383
111179,2067,2,1,3,N,29.20201497883607
173865,2067,7,0,7,E,29.60135812806662
107425,2067,6,2,8,E,29.497470828156512
48194,2068,5,1,6,N,28.65663798927379
133632,2068,3,1,4,E,28.817960286929708
55077,2068,3,0,3,E,28.729782137351773
148586,2068,6,2,8,N,28.73094427661248
84726,2067,2,2,4,Q,29.220137345630263
164713,2068,5,1,6,Q,28.85452296362474
126346,2067,7,0,7,N,29.61246561469681
102305,2068,4,3,7,M,28.72888308020249
69651,2068,7,1,8,D,28.834197970907216
147793,2067,5,3,8,M,29.19399835204208
143854,2068,2,2,4,M,29.06999186258472
125185,2068,4,1,5,A,29.028808964302
50770,2067,4,1,5,M,28.903388608286484
49080,2067,8,2,10,H,29.18914933044872
25963,2068,2,2,4,J,28.88647968864767
157159,2068,3,2,5,D,28.81993934664931
125256,2067,2,2,4,M,28.90485994082344
144249,2068,7,2,9,M,28.867545697129938
28085,2067,3,2,5,D,29.15076575059904
54375,2067,5,0,5,H,29.262751387776227
32833,2067,4,2,6,N,29.05362836858434
83166,2067,13,2,15,P,28.96748419119508
38970,2068,6,1,7,J,29.05427953510913
136687,2068,4,0,4,Q,28.83444855087936
64657,2067,6,2,8,S,28.88402582554339
137369,2067,3,0,3,M,29.30941164602445
114498,2068,6,2,8,E,28.75151294768213
91870,2067,3,3,6,N,29.14598376002337
77552,2067,6,2,8,M,29.30336516251949
65475,2068,7,1,8,N,29.011603525497325
146145,2068,4,2,6,Q,28.698178654525645
162161,2068,3,0,3,J,28.85966609099048
94474,2067,8,1,9,J,29.153874818398588
177806,2067,4,1,5,P,29.030083846149942
145139,2068,5,0,5,M,28.810708727344217
38109,2067,3,2,5,K,29.205333020548757
108568,2067,3,1,4,E,29.389084970615237
66795,2068,4,1,5,E,28.977836333013727
84413,2068,3,1,4,E,28.8446744178382
161259,2068,7,4,11,F,29.263929385132087
110076,2067,5,2,7,J,29.22806403923194
21241,2068,5,2,7,N,28.957977063396758
37190,2068,3,1,4,K,28.734131932708323
137683,2067,6,2,8,M,29.04398040990886
41909,2067,6,3,9,I,29.234210478855157
121608,2067,7,1,8,J,28.959417894889203
166867,2067,5,0,5,I,28.991377982812672
173703,2068,5,2,7,H,29.15435156184821
93144,2068,8,2,10,I,28.93830939728182
78599,2067,5,2,7,Q,29.0527014304084
92209,2068,4,1,5,S,29.07608602618584
120834,2067,3,2,5,N,29.20451951432181
106457,2068,9,4,13,M,29.104552608987262
31072,2067,3,2,5,D,29.22724949114228
64860,2068,5,1,6,J,28.96858092325828
38579,2067,2,1,3,E,28.995949107526684
86896,2068,5,2,7,E,28.886112121779966
89203,2067,4,3,7,P,29.14940747323001
173329,2068,3,1,4,E,28.390136242693664
144818,2067,2,3,5,Q,29.31012984369266
149489,2068,3,2,5,M,28.990286262801245
169846,2068,6,0,6,M,29.0805815276595
50904,2067,3,2,5,S,29.170536829263597
64965,2067,2,2,4,P,29.24077905666733
146858,2067,2,1,3,M,29.102972927110507
22766,2068,4,0,4,M,28.92642521372479
63602,2067,3,0,3,Q,28.842413858438675
96517,2068,3,1,4,E,28.85425857117836
111340,2067,7,0,7,K,29.222942769218506
123885,2067,4,2,6,A,28.974701643916564
172094,2067,5,0,5,Q,29.322697377405422
59288,2067,8,1,9,D,29.031461137771107
87839,2068,5,2,7,N,28.94155245988597
84870,2067,5,0,5,P,29.292811892557182
94940,2067,6,0,6,Q,29.231042036287477
119839,2068,14,4,18,E,28.918677307375496
70481,2068,3,0,3,E,28.51077477102244
161951,2067,2,1,3,S,29.196630429834677
78477,2067,4,1,5,K,29.107064545887432
181616,2067,7,0,7,N,29.255215416137045
135426,2067,8,2,10,E,29.309322481013467
55260,2067,1,1,2,A,29.272962177959588
131145,2068,4,1,5,M,28.744646946449876
41536,2067,5,2,7,N,29.37223730723342
27041,2067,1,2,3,E,29.19393334330439
81451,2068,6,1,7,D,29.02927075712485
172658,2068,5,0,5,E,28.5910434354608
20017,2068,7,3,10,D,28.834177642463064
125349,2068,2,1,3,K,29.117987785234742
112523,2068,0,4,4,E,28.875473686875768
50866,2068,2,3,5,M,28.942153286117875
20917,2068,8,0,8,H,28.80231200717537
63915,2067,6,0,6,J,29.25749891792458
133680,2068,5,2,7,K,28.99110144735093
48889,2068,5,0,5,E,28.728475347716103
92577,2067,5,2,7,N,29.41949948482385
128954,2067,4,0,4,E,29.311931553043355
134317,2068,6,1,7,E,28.567630555398782
44626,2068,9,5,14,D,29.04125203206422
147383,2068,2,1,3,A,28.84313278906857
82907,2068,4,2,6,D,29.09020923684736
59095,2067,5,2,7,P,29.313660456804204
91801,2068,4,2,6,P,28.707963767715874
142459,2067,5,2,7,E,29.32483581419892
162219,2068,4,1,5,N,28.9629693621846
26934,2068,7,2,9,Q,28.92088326589336
158588,2067,5,2,7,D,29.20909930000867
91741,2067,3,2,5,N,29.023406729818134
95389,2068,3,0,3,D,28.73877397327793
177637,2068,1,3,4,I,28.71172213835733
129465,2068,2,2,4,K,28.764205040377718
167740,2068,4,0,4,F,28.88571033162531
146773,2068,2,1,3,N,28.864591277044145
81409,2067,3,1,4,N,28.97452004185386
33395,2067,6,1,7,K,29.218813718586528
103493,2067,8,0,8,E,28.917572798867656
140636,2068,5,1,6,K,28.89950844780024
160347,2068,4,0,4,P,28.951427417195337
166077,2067,5,2,7,E,29.07643965699577
148836,2067,7,2,9,M,29.16631397383851
180713,2067,3,1,4,E,29.168211015680903
111114,2067,2,1,3,N,29.0478140188007
22231,2068,5,1,6,N,29.046469053289304
122668,2068,2,2,4,N,29.05546238493984
24021,2067,6,1,7,D,29.06901086470653
82191,2068,5,1,6,A,28.904871117231725
64110,2068,5,0,5,Q,28.828771098073588
46032,2068,5,0,5,Q,28.69483638042321
110706,2068,4,1,5,K,28.484711780104647
170701,2067,4,0,4,E,28.94110092566374
48521,2068,4,1,5,D,28.92245273475882
145796,2067,3,2,5,M,29.43988150000293
37461,2068,4,0,4,H,29.26265596170407
50116,2068,4,2,6,I,28.716374763009327
113636,2067,5,0,5,J,28.948177798909068
106425,2067,7,2,9,N,28.845931438664408
120584,2068,6,0,6,N,28.903654000619355
95201,2068,6,2,8,J,28.458567843180624
145039,2068,4,1,5,K,28.875797917620385
66944,2067,4,0,4,A,29.26547659598709
114729,2068,4,2,6,P,28.79270765367825
82437,2067,7,0,7,P,29.25187677698901
161605,2068,7,1,8,E,28.55326607312502
115160,2067,2,3,5,N,28.929639347440045
167944,2067,5,2,7,A,29.156811201199613
111958,2067,6,2,8,E,29.147927087425064
156848,2068,4,2,6,M,28.967058405975987
82403,2067,8,1,9,A,29.243719952900747
15980,2068,2,3,5,Q,28.89998744878018
105283,2068,2,4,6,J,28.750485980186312
77927,2068,6,1,7,K,28.71109049772345
172817,2067,2,0,2,M,29.218393089816608
19145,2067,10,2,12,P,29.584366905693116
70403,2067,2,0,2,D,28.90019339315238
40042,2068,4,1,5,E,29.02223722114289
71348,2068,4,1,5,E,28.884235114102005
169613,2068,5,2,7,R,28.94599347564486
51148,2068,1,2,3,S,29.052389719072405
135350,2068,2,1,3,D,28.79662958918602
102861,2068,7,2,9,E,29.204347147207724
106597,2068,4,2,6,E,28.798278958074896
149732,2068,2,2,4,M,28.78071852608442
23442,2067,5,2,7,E,29.173887163666063
109504,2067,4,2,6,E,29.157250245642413
147715,2068,5,1,6,E,28.875214030476805
179997,2068,7,0,7,Q,28.720072905724617
125582,2068,6,0,6,E,28.80970748263675
97798,2068,3,2,5,P,29.08783611880086
53025,2068,7,2,9,Q,28.667589026465837
175538,2068,7,1,8,M,28.759165507495133
31666,2067,3,1,4,K,29.05276771582654
117161,2067,3,2,5,Q,29.464632349492607
147613,2068,7,1,8,P,28.86173524476288
61651,2068,3,0,3,Q,29.169678432434083
69291,2067,3,2,5,N,29.00095853290765
84462,2067,5,1,6,N,29.05335568285756
167070,2067,6,0,6,Q,29.25538574013217
142958,2067,4,1,5,M,29.24523083785495
26325,2067,4,3,7,J,29.29109734858361
155916,2067,14,3,17,A,29.240924246097823
22388,2067,4,2,6,K,29.16696808671885
159212,2067,2,2,4,E,29.311193016215377
146815,2067,2,0,2,M,29.21389551282988
16727,2067,5,1,6,N,29.514235665709563
69623,2068,7,0,7,D,28.622540689971373
124987,2068,5,0,5,Q,28.952512333245767
137112,2067,3,0,3,J,29.011336506704524
148686,2068,8,3,11,M,28.985839867409723
133426,2068,1,4,5,E,28.892593673464727
62046,2067,5,2,7,E,29.223567346576573
30762,2067,3,2,5,E,29.208809994777653
170800,2068,3,2,5,D,28.5385825133915
38285,2067,3,3,6,N,29.16043799358204
106345,2068,2,2,4,Q,29.000490448055253
47395,2067,5,2,7,E,29.28544069779737
159851,2067,3,1,4,D,29.394909639532845
144639,2067,7,2,9,M,29.392632797975875
53132,2067,5,1,6,K,29.19133536968504
50980,2068,4,2,6,S,28.94386845408796
88091,2068,3,2,5,E,28.63741763265379
96668,2068,5,1,6,E,28.777085698113854
58779,2068,4,0,4,J,28.85247345556792
111925,2067,6,2,8,K,29.15793908050855
73533,2068,5,2,7,D,29.019397739546644
115870,2068,4,0,4,J,28.88060006918712
144828,2068,6,3,9,M,29.10034549045932
73379,2067,4,2,6,D,29.27307682448172
112202,2068,5,2,7,Q,28.68392612304369
131177,2067,3,0,3,E,29.093135721734168
148018,2067,4,2,6,Q,29.52652616800725
175918,2067,5,2,7,J,29.055560959777864
142494,2067,7,2,9,P,29.011548703646
92986,2067,2,0,2,E,29.39050311217344
89557,2068,4,2,6,N,29.145350674945192
17125,2067,6,1,7,N,29.231622657725914
164910,2068,6,3,9,E,28.8080384763934
146052,2067,7,0,7,P,29.002497698592503
28472,2068,3,1,4,G,28.684291856682165
48823,2068,8,0,8,J,28.986552128883066
173467,2068,5,2,7,J,29.011717264907528
110799,2068,7,0,7,E,28.97398888796972
89535,2067,5,0,5,E,29.12786715131656
114311,2067,1,3,4,N,29.3364164992656
174123,2068,6,3,9,F,28.908603695717247
179645,2068,5,2,7,J,29.06142312271538
69601,2068,4,0,4,F,29.290865944087717
69840,2067,8,0,8,Q,28.674927046915656
105215,2068,8,1,9,J,28.59971090155748
75611,2067,3,0,3,E,29.126284472817
54818,2068,5,2,7,N,28.758705296316823
53719,2068,4,3,7,K,28.53134035567565
41088,2068,7,2,9,Q,28.725079346445384
117861,2068,3,2,5,D,28.73247641226358
33830,2067,6,3,9,P,29.388885144082977
37005,2067,6,3,9,N,29.30578697115965
114312,2068,9,0,9,F,28.956261550394743
120072,2068,3,2,5,P,28.872736905853746
127293,2067,4,0,4,J,29.20791814882629
173238,2068,2,0,2,E,28.85080338237989
95457,2067,4,3,7,N,29.286117356785777
104883,2068,6,2,8,K,28.982491092516064
25359,2067,4,2,6,P,29.05854626403717
90472,2068,3,1,4,D,28.977172764349167
108529,2067,5,3,8,K,29.48961842010512
31451,2068,3,2,5,J,28.590006464926372
82268,2067,4,1,5,E,29.27502408798344
129045,2067,5,2,7,E,29.009092658120128
109097,2068,4,2,6,N,28.850808722995996
77716,2068,3,1,4,Q,28.85663185416362
40776,2068,7,1,8,Q,28.992589671222216
180623,2067,2,2,4,D,29.243849422299903
60112,2068,6,0,6,P,29.023588282234957
148549,2067,6,2,8,M,29.304007865583824
168253,2068,4,0,4,C,29.0779295078612
51440,2067,3,1,4,E,29.392834689416187
93479,2067,6,0,6,J,29.431355834027347
161616,2067,3,0,3,Q,29.35434124124333
174941,2067,6,2,8,P,29.306675737315796
19359,2067,4,1,5,M,29.183836603586904
124913,2067,3,0,3,K,28.98932623971581
107532,2068,2,2,4,K,28.53650570042263
21841,2068,5,1,6,D,28.648777019273272
72874,2067,3,3,6,J,29.25901414333808
140736,2068,8,2,10,E,28.80154051433052
147387,2068,4,0,4,P,28.471445004716102
111533,2067,3,3,6,E,29.392455582700563
173987,2068,3,2,5,N,28.899962954086437
149383,2068,7,1,8,M,28.50804499616535
141999,2067,5,2,7,M,29.459955209893057
60616,2068,2,0,2,D,29.00820254204421
84488,2068,5,1,6,Q,28.955602800963884
95493,2067,4,3,7,Q,29.01575437878909
66945,2068,2,2,4,D,28.926805880734214
16403,2068,4,1,5,P,28.8335200360181
38483,2068,5,1,6,J,28.57498453550168
16466,2068,5,2,7,P,28.806210523459804
160173,2067,0,3,3,E,29.16985135568523
96217,2067,3,1,4,R,29.37886255180574
92938,2067,5,3,8,Q,29.28106150799305
26981,2068,3,1,4,N,28.588871497968334
147397,2068,7,2,9,Q,28.93196123007362
162524,2067,2,2,4,N,29.206017273435315
77304,2068,6,0,6,E,28.613080807655717
68023,2067,4,2,6,N,29.31640123053533
70186,2067,5,1,6,D,28.9393445449032
157833,2067,11,1,12,D,29.16381626977244
138787,2067,6,2,8,Q,28.780806958371528
22758,2068,3,2,5,M,28.973848436546792
39931,2068,5,1,6,N,28.822559253870494
78035,2068,4,2,6,Q,28.84030972131823
96814,2068,5,3,8,A,28.91169788412333
134618,2067,4,1,5,N,29.084190334093424
73579,2068,3,2,5,D,28.693997919992984
104577,2067,2,2,4,N,28.99797295602191
117981,2067,6,1,7,E,29.30031465536335
70143,2068,4,0,4,D,28.91115728662937
144475,2068,1,1,2,M,28.64124763628067
110680,2068,2,2,4,E,28.71046218847808
88238,2067,6,0,6,N,29.28986200123099
101150,2067,5,1,6,N,29.331438580241564
139578,2067,4,2,6,Q,29.318310594573937
137780,2068,8,2,10,J,28.87921223660421
98676,2068,5,2,7,J,28.67369902381656
88378,2067,7,2,9,Q,28.91622988479025
124708,2067,3,1,4,Q,29.00997525641342
99682,2067,6,2,8,Q,29.273755365158795
107384,2068,5,4,9,J,28.973471782021704
49023,2067,6,2,8,J,29.32559761650172
127508,2068,5,2,7,Q,28.912046330900324
27943,2067,7,1,8,K,29.52685594819734
59571,2068,4,2,6,E,28.837320981913383
144070,2068,5,1,6,S,28.94971720625258
72546,2068,4,1,5,N,28.9550833843743
128322,2067,5,0,5,N,28.958891977231502
148680,2068,4,2,6,M,28.95035910993344
93041,2067,2,1,3,E,29.3441343867541
22277,2068,6,2,8,J,28.69265998900793
127510,2068,2,0,2,M,28.7228245887857
97137,2068,4,1,5,N,28.90352493850976
29763,2068,4,1,5,D,28.71399913276122
110599,2068,2,2,4,J,28.39978936069889
159331,2068,3,2,5,N,29.006592505911225
17216,2068,4,1,5,H,28.94146911882731
144577,2067,7,0,7,M,29.24544204515076
51767,2068,7,2,9,E,28.74864680787593
30087,2067,2,2,4,Q,29.05330936830445
167732,2068,6,2,8,J,29.169185421767597
122664,2068,6,2,8,N,28.89674390038196
181512,2068,7,1,8,Q,28.8506060582495
175332,2068,1,3,4,R,29.10809986155766
67991,2068,5,1,6,N,28.80895023989569
32144,2067,6,1,7,E,29.096458041442403
42764,2068,5,3,8,M,28.842397673272565
48196,2067,6,1,7,D,29.40594384918821
24769,2068,5,3,8,D,28.546558406494366
163264,2068,5,2,7,J,28.90178503433748
145711,2067,3,2,5,M,29.1463971791319
151118,2068,6,0,6,M,29.05474549870523
38807,2067,3,3,6,S,29.09351985418413
63759,2068,5,1,6,P,28.569032433271595
127165,2068,7,1,8,J,28.985251485354823
147063,2068,4,2,6,S,29.036839427941523
111977,2067,6,0,6,E,28.93754856003204
49477,2067,3,1,4,A,29.190155208675243
181003,2067,2,1,3,E,28.894112451406624
69634,2068,5,0,5,E,28.89489965330504
91719,2068,10,1,11,Q,28.50665105098768
181876,2067,6,4,10,P,29.59072386032263
54782,2067,4,2,6,M,29.08823638611176
127918,2068,3,2,5,J,28.973534058945184
79228,2068,5,3,8,N,28.717822779859763
156301,2068,4,2,6,N,29.010448139645792
20963,2067,1,1,2,J,29.26898992584701
106188,2067,8,1,9,Q,28.98427911105512
25847,2068,7,1,8,J,28.959357717378573
93664,2067,7,1,8,N,28.883463242493765
15878,2068,5,0,5,Q,29.04900642959842
30058,2068,6,2,8,Q,28.7033763733407
47502,2068,6,1,7,E,28.68040596567789
179834,2068,5,3,8,J,28.97698611892186
63323,2067,2,3,5,N,29.27066493902304
111241,2068,2,1,3,K,28.735033800968854
47530,2068,6,0,6,N,28.57971711547226
173424,2068,7,2,9,E,28.91372558360472
40842,2067,3,1,4,Q,29.208102594639232
111524,2067,8,0,8,J,29.061293157334948
75395,2068,1,3,4,J,28.64903737332073
99049,2068,6,0,6,E,28.784744003633207
180636,2067,3,1,4,N,29.227238732133078
111200,2068,2,4,6,E,29.03574943206376
165892,2067,7,2,9,P,29.41096631169561
175280,2067,7,2,9,M,29.322999122400788
122799,2067,6,0,6,P,29.300745940347568
77047,2068,3,2,5,E,29.092046771632187
133678,2068,3,1,4,E,29.131024538180935
142848,2068,4,1,5,E,29.165302726340336
90467,2067,4,1,5,M,29.069612355059174
77489,2068,2,1,3,M,28.859792907653155
45173,2067,2,1,3,J,29.09259464264606
163512,2067,4,0,4,M,29.24341040748714
120193,2068,3,2,5,E,28.86631940527443
132328,2067,8,2,10,M,29.184735539291093
158973,2068,5,2,7,M,28.54002781326355
176801,2068,5,0,5,P,29.021051927334447
117393,2067,8,0,8,N,28.986493146254176
104879,2067,5,3,8,Q,29.22276309525954
113319,2068,6,2,8,M,28.96507344376317
121347,2067,5,3,8,E,29.480646095987066
122263,2068,6,4,10,J,29.05728113905689
40762,2068,5,1,6,D,29.240231620592244
38927,2068,5,1,6,N,28.84649809280725
64018,2068,9,2,11,A,28.61140879438449
102603,2067,7,0,7,N,29.19026483243061
84412,2067,4,2,6,N,29.33358729634593
106450,2067,5,2,7,N,29.356065165839947
23544,2067,7,2,9,D,29.22194040984996
132283,2068,9,3,12,J,29.467322143775792
97388,2068,11,1,12,M,29.06495806230367
127617,2067,5,2,7,J,28.94622947153373
35599,2068,3,2,5,P,28.770898690413443
133676,2067,3,2,5,J,29.332908283885867
116546,2068,4,1,5,E,28.67444711654524
55021,2068,7,2,9,H,29.086140810065707
50629,2068,5,0,5,N,29.075472714371895
56783,2068,2,1,3,M,28.69422433343991
174302,2067,4,3,7,D,29.41556264145319
156006,2067,5,2,7,E,29.32764924853492
179741,2067,3,2,5,N,28.898905286238698
117000,2068,2,2,4,K,28.93957200243428
86802,2068,3,3,6,J,28.816972690556423
143153,2068,6,1,7,M,28.62623774032597
138934,2067,2,2,4,J,28.7972774029201
120573,2067,6,2,8,J,29.555314846574813
81268,2067,3,2,5,P,28.86115767305633
92051,2068,6,1,7,P,28.92007232647948
100765,2068,4,1,5,J,29.111084740521505
147914,2067,3,4,7,N,29.250657304715144
47864,2067,11,1,12,M,29.10349903620109
100805,2067,4,1,5,E,29.401306595459133
146775,2068,5,0,5,M,28.52781064898207
117463,2067,7,4,11,I,29.16112100460601
78253,2067,7,0,7,E,29.4076810170162
69738,2067,3,0,3,P,29.219645522292165
138198,2067,4,2,6,E,29.45584469466024
129963,2067,7,1,8,E,29.041803619838607
167287,2067,3,0,3,M,29.30311203288288
47385,2067,4,1,5,N,29.16428321232182
91944,2068,5,2,7,E,28.722733753919627
85203,2068,5,1,6,I,29.022788056554106
161915,2067,6,2,8,H,29.05464218085542
16092,2067,4,2,6,A,28.995993039575257
166461,2067,4,1,5,M,29.243490296656187
96620,2067,2,2,4,S,29.05544886981294
59437,2068,5,1,6,E,28.736475899562823
144020,2068,2,2,4,S,28.86974266231022
131488,2068,4,2,6,I,28.783102752443494
81269,2067,4,2,6,Q,28.89710396766539
77146,2067,7,1,8,M,29.20017811209206
22442,2067,2,1,3,D,28.8072907844696
87067,2067,4,2,6,J,29.099519557556714
160467,2067,4,1,5,C,29.346786838283236
121007,2067,5,1,6,M,29.22418330771977
173702,2068,6,0,6,E,28.47962861147656
19262,2068,4,2,6,C,29.11545464760211
23568,2067,3,3,6,N,29.3515466662359
93975,2067,3,1,4,J,29.006171841795844
177231,2067,3,3,6,S,29.082206958303523
52046,2068,5,2,7,J,28.933404462062825
78631,2067,3,1,4,M,29.15473706469137
55765,2068,3,1,4,E,29.07966136292944
95034,2068,5,2,7,J,29.156150078204845
176701,2067,4,1,5,E,29.276012115250168
86631,2068,4,1,5,N,28.97419939427456
95391,2067,2,2,4,S,29.46671542158637
169981,2067,8,2,10,P,29.486159710808387
50437,2068,4,2,6,E,28.9445602526204
103072,2067,3,3,6,J,28.914640002357725
132126,2068,6,1,7,E,28.841450099188418
158286,2068,4,2,6,N,28.65271799503163
93777,2068,5,2,7,D,29.00212759078121
28529,2068,4,3,7,E,29.20879789243624
115314,2068,3,2,5,N,28.5594543353379
149367,2068,6,3,9,P,29.191942735636697
29098,2068,6,1,7,E,28.943144325865656
133752,2067,6,1,7,P,29.052137937394228
97809,2068,5,3,8,D,28.982426982057188
170977,2068,4,3,7,N,28.74229985444973
36740,2068,3,0,3,P,28.818694448045417
98212,2068,5,2,7,N,28.71443031303912
135937,2068,5,2,7,P,28.67540575033452
109277,2067,3,1,4,Q,29.23363237487245
111228,2068,2,1,3,J,28.859133743820312
156543,2068,4,2,6,A,29.035683494382223
121161,2067,3,0,3,N,29.292980382751907
122636,2067,5,1,6,P,29.38968870152181
182395,2067,6,1,7,Q,29.06420830321721
28791,2068,2,2,4,S,28.905917563505827
52275,2067,5,3,8,N,28.94112048697125
78318,2068,3,2,5,E,28.96650761561881
83493,2068,2,3,5,I,28.78875951412537
49429,2068,5,1,6,D,28.66889413291892
117641,2068,5,3,8,I,29.092781065639752
144526,2068,3,2,5,M,28.63884619960525
162428,2067,5,3,8,E,29.3022620211928
107527,2068,2,1,3,Q,28.986429086451214
130282,2067,4,0,4,Q,29.208562672924916
114537,2067,3,1,4,E,29.36039702047266
53745,2068,6,2,8,J,29.113124583504995
16924,2067,3,2,5,P,29.218913475229726
38901,2068,11,1,12,H,28.77063519633844
110427,2067,6,1,7,D,29.292013730915134
92426,2067,4,2,6,I,29.25699648284146
15905,2067,5,1,6,J,29.162740414143716
143354,2067,2,2,4,D,29.008318488706603
31060,2068,6,2,8,J,28.888018372425957
48571,2068,6,0,6,D,28.93557849521235
113655,2068,12,1,13,E,28.71227151347509
181790,2068,3,5,8,M,28.70257471908509
72822,2068,7,1,8,E,28.70844892853833
41185,2068,2,3,5,J,28.490408291058465
176324,2068,7,2,9,N,28.691290873062663
16706,2068,2,0,2,S,29.016718358315902
178693,2068,3,3,6,Q,28.563578507295357
59244,2067,7,3,10,S,29.31224499860286
92985,2068,4,3,7,J,29.249401792900358
29422,2067,3,0,3,E,29.25502549281995
142477,2067,5,0,5,E,29.3820864095793
130846,2068,6,1,7,N,28.666667892343863
92343,2067,6,1,7,D,29.040045667773597
58932,2068,5,1,6,D,28.584503063284163
24170,2067,4,0,4,N,29.458884857437702
136312,2068,3,0,3,J,28.832144805713668
146470,2068,5,1,6,M,29.07690428544368
156663,2068,3,3,6,E,28.795337532683245
88176,2068,4,1,5,E,28.94146897610857
147681,2068,8,0,8,E,28.86603760003572
112366,2068,5,2,7,M,28.723397410502336
73942,2067,5,2,7,Q,29.11423606151445
157020,2067,6,2,8,P,29.25612376835578
104609,2067,2,1,3,J,28.72165301299125
182164,2068,8,4,12,C,28.86819524198984
109838,2068,5,0,5,E,28.95442765888064
156813,2068,5,1,6,E,28.91038524229005
92278,2068,7,0,7,P,28.75016277040088
143380,2067,9,1,10,E,28.97516798483772
113348,2067,3,1,4,N,29.46929786266074
49898,2067,5,0,5,J,29.2311116338365
162194,2068,6,2,8,E,28.779241783642757
95680,2067,10,3,13,F,29.1794006396452
28037,2067,4,0,4,Q,29.894945058034608
177016,2067,2,1,3,N,29.026608332579112
32041,2067,1,3,4,I,28.9461987444142
88723,2067,4,2,6,E,29.318826454402675
60200,2068,3,1,4,P,28.68142469711987
130216,2068,2,2,4,M,29.027775789989185
135860,2067,6,2,8,M,29.037478449675277
121362,2068,2,1,3,K,28.69056908603853
27910,2068,3,2,5,D,29.12270865439352
125500,2067,4,0,4,M,29.06057614339687
134538,2067,4,1,5,N,28.929353732839463
163986,2068,3,2,5,E,29.020023065651003
108333,2068,2,2,4,N,29.00301607870636
103754,2068,4,1,5,E,28.93809051401105
179430,2068,2,1,3,J,29.07036648936753
86770,2067,2,2,4,Q,29.183177698513163
125206,2068,2,2,4,N,28.778588972934266
131337,2067,4,2,6,P,29.091479052835613
74379,2067,3,2,5,D,29.19235642490689
93033,2068,6,2,8,N,28.34437928084217
142887,2067,3,1,4,K,29.49454602221194
125035,2068,6,0,6,J,28.93895247162711
82536,2067,3,1,4,S,29.345576342975804
145431,2067,5,2,7,M,29.031186498253643
100367,2067,8,3,11,N,29.219874484673397
109948,2068,1,3,4,J,28.670195238229645
34122,2068,6,1,7,Q,28.81760503890257
58976,2067,4,0,4,N,29.01250677349747
133691,2068,5,3,8,Q,28.90656479917816
87074,2067,6,2,8,D,29.375934440575996
101548,2068,9,2,11,Q,28.779342574866387
160696,2068,5,0,5,E,28.872007269179715
173730,2067,6,0,6,Q,29.149379587981183
128470,2068,2,1,3,P,29.08882043810241
148851,2067,1,1,2,M,29.15466765646909
145934,2068,2,3,5,M,28.696281310387988
56781,2068,4,1,5,F,28.77482088107918
141320,2068,6,0,6,M,28.940441279496252
150791,2068,5,2,7,Q,28.804139896227547
162972,2068,5,3,8,N,28.598186495387928
60251,2068,2,2,4,N,28.66117994059318
127085,2068,3,3,6,E,28.872504458085604
164488,2067,6,1,7,R,28.96220139201876
135704,2067,3,1,4,J,29.21792710416996
158861,2068,4,3,7,N,28.793986397113063
22532,2068,5,0,5,S,28.81284754921007
178181,2068,1,2,3,D,29.21944449012703
171913,2068,3,1,4,S,28.886600976015966
179133,2067,6,2,8,J,29.418356615204694
96039,2067,4,0,4,J,29.114087548401308
161259,2067,3,1,4,F,29.2731311919858
21086,2068,4,1,5,S,28.85421997131312
101457,2067,4,0,4,F,29.257797681876017
41159,2067,3,1,4,M,29.134792593951275
100944,2067,4,0,4,E,29.2482768398076
60435,2068,5,1,6,N,28.69236767970325
56730,2067,4,3,7,N,29.133496929289585
63636,2067,4,1,5,P,29.13428516524456
142872,2067,6,4,10,M,29.10736742727712
127975,2068,2,2,4,M,28.939348620087344
120689,2068,9,2,11,E,29.029370739354057
156658,2068,4,1,5,Q,28.955814567982703
90481,2068,3,0,3,F,28.981466043326733
163202,2068,3,2,5,E,28.915117623936624
120058,2068,5,2,7,E,28.947038410899765
121737,2067,4,2,6,Q,29.145047179004838
158016,2068,5,0,5,N,29.02634567773843
101457,2068,6,2,8,F,28.898765421604324
171279,2067,3,2,5,D,29.15046436346112
74503,2068,6,1,7,J,28.89598289552442
49018,2068,4,2,6,E,28.83067759775428
18281,2067,6,1,7,S,29.1315499590488
147847,2068,3,2,5,N,28.92509598259926
86216,2067,6,3,9,E,29.126586548709305
56275,2068,3,1,4,J,29.12650730737981
90133,2067,2,2,4,E,29.3451436922396
35545,2068,5,2,7,P,28.976891713505896
49004,2067,4,3,7,J,29.08919784749428
124695,2067,4,3,7,E,29.437362559428266
44905,2067,3,3,6,S,29.26694575314149
173183,2068,4,1,5,D,28.971810156917638
89535,2068,6,1,7,E,28.89095751360028
25030,2067,4,2,6,J,29.24342304135939
159310,2068,4,0,4,Q,28.61602006883539
85484,2068,4,2,6,E,28.903207995445094
149104,2068,4,2,6,M,28.831666310737205
67390,2068,4,2,6,Q,29.136661643460418
141502,2068,7,0,7,H,29.00805116790325
25619,2067,4,2,6,N,29.43797859439736
62884,2067,3,2,5,E,28.895896620217076
37278,2068,3,1,4,S,29.0390560066434
29488,2067,9,5,14,A,29.134204037028283
51473,2068,6,2,8,P,28.841139211096287
41119,2068,8,1,9,N,28.40976445192509
35612,2067,2,0,2,C,28.94750644377918
150980,2068,7,2,9,E,29.146389355766757
65925,2068,4,2,6,E,28.84557244384027
31748,2068,4,1,5,Q,29.11776744494328
93435,2067,4,1,5,J,29.396302949325563
83388,2068,2,2,4,J,28.67597333275575
128733,2067,6,1,7,M,28.88378838577639
175274,2068,1,3,4,K,28.661553637960395
146322,2067,11,2,13,E,29.35404498477517
182531,2068,4,1,5,J,28.95410562459781
62597,2068,6,4,10,C,28.806083689236605
120197,2068,6,4,10,E,28.930866506828163
103706,2068,7,1,8,E,28.902855057526317
100872,2068,3,2,5,Q,28.65394418591908
163964,2067,6,0,6,N,29.146704057564264
145631,2067,2,1,3,M,29.09571142794779
131525,2067,3,1,4,E,29.21241009497161
103885,2067,2,1,3,J,29.11486498444159
138197,2068,6,0,6,J,28.80749797775856
21897,2067,4,0,4,M,29.228100119091263
21302,2068,4,1,5,J,28.747888201827365
63559,2067,11,1,12,D,29.55491468342415
16727,2068,6,0,6,N,29.1705846489359
117996,2068,5,1,6,J,28.773293372848773
141755,2068,6,0,6,J,29.1985654638077
55328,2068,3,2,5,Q,28.61601805052825
60195,2068,7,1,8,P,28.920181130811784
54222,2068,5,2,7,Q,29.106721709418952
100903,2067,2,0,2,D,29.07714194005353
177474,2067,3,0,3,E,29.11199779580946
123052,2067,6,0,6,P,29.24609428313893
114245,2067,8,1,9,E,28.99082290636493
65918,2068,2,2,4,P,29.02436514341079
94491,2067,6,1,7,P,28.9503854779781
59130,2067,8,3,11,D,29.32110090859671
66234,2068,3,0,3,Q,28.94732457404033
137167,2067,1,1,2,M,29.086880658750733
116106,2068,6,2,8,M,28.66143417514596
133680,2067,4,1,5,K,29.19546154056302
68040,2067,11,1,12,E,29.076800728127303
63981,2068,2,2,4,N,28.571535020838112
165578,2068,2,1,3,J,29.00992305867504
30977,2068,5,2,7,D,28.94177524272023
56685,2067,3,0,3,Q,29.13218290201807
118423,2067,2,0,2,P,29.535053609582505
163088,2068,7,1,8,M,28.8500865611169
44871,2067,4,1,5,D,29.34963992140982
60177,2068,13,0,13,D,28.73946031727086
146069,2067,4,0,4,M,29.519868564135777
161013,2067,6,1,7,K,28.861702333682057
51036,2068,11,2,13,K,29.06733488110248
111519,2068,6,1,7,J,29.25696525504957
56176,2067,4,1,5,N,29.065099856786222
40381,2068,3,1,4,E,28.75826146481572
78994,2068,3,1,4,D,28.95514308382492
109233,2068,5,2,7,J,29.033628680897564
21546,2067,3,0,3,P,29.35673462368681
122533,2068,6,1,7,E,28.925216532469385
93024,2068,4,1,5,A,28.909484320938912
169886,2067,20,3,23,E,29.237079843874028
179834,2067,3,3,6,J,28.95193677212688
147007,2067,6,1,7,M,29.224715969593973
105332,2067,4,3,7,N,29.61255660809095
76787,2068,8,0,8,E,28.88530088920666
67262,2068,4,2,6,A,29.046272359690903
40067,2068,2,3,5,S,29.220645329660844
83764,2068,6,2,8,M,28.87184261545568
28117,2067,3,1,4,J,29.105970952155698
110706,2067,7,0,7,K,29.454097812289504
138328,2068,4,2,6,M,29.06755911659778
108049,2068,2,0,2,K,29.181010394122605
102115,2068,7,1,8,E,28.86173221692913
123954,2068,6,2,8,M,28.99651568442364
63314,2067,5,1,6,E,29.056453460229328
63136,2068,7,2,9,A,28.942828874919368
67818,2068,5,1,6,E,28.76525972148725
137593,2067,5,2,7,M,29.061083396713265
50735,2067,1,2,3,N,29.40504545151277
88956,2068,4,1,5,E,28.79467758414405
22928,2068,7,1,8,J,28.92133717688952
100078,2068,9,3,12,E,28.98348479388985
39104,2068,4,1,5,Q,28.972984427324704
88388,2068,4,1,5,D,28.976165614409148
171262,2067,4,1,5,K,28.925503103410605
20843,2067,3,0,3,N,29.065469411684408
121184,2068,4,2,6,E,29.222829219309656
18992,2068,5,1,6,E,28.632772897838624
96508,2067,4,1,5,K,29.06775491496686
135204,2068,7,2,9,P,28.694340293239986
156451,2068,5,1,6,P,28.903350113018867
158514,2067,5,2,7,Q,28.93146069381904
147241,2067,4,0,4,J,28.962008460346727
73813,2068,5,2,7,P,28.859952561942432
69388,2068,4,2,6,N,28.94890374848801
165315,2068,6,3,9,D,28.929713279885927
128847,2068,2,3,5,E,28.84780788153935
30741,2068,5,2,7,D,28.680076553213443
57278,2068,6,2,8,K,28.91788833534175
124527,2068,5,3,8,E,28.851806753928603
92209,2067,4,0,4,S,29.35937556598212
134659,2068,4,1,5,Q,29.01283011660436
30826,2067,2,2,4,E,29.485623121271622
101846,2068,3,4,7,E,28.73606828735232
33304,2068,2,2,4,Q,28.993658417111675
113074,2068,7,0,7,Q,28.903369939640346
114402,2067,3,1,4,J,29.15981350667169
40131,2068,5,3,8,I,28.764790150951963
150348,2068,4,2,6,M,28.867064474171546
165564,2067,7,1,8,P,29.1694632556371
111525,2068,5,2,7,J,28.765544557020352
56488,2067,2,1,3,M,28.97724192951711
65324,2067,5,1,6,D,28.82259756265693
99006,2068,7,0,7,E,28.88397185120605
41905,2068,5,2,7,M,29.219775675559912
40131,2067,5,1,6,I,28.88249155305612
111925,2068,6,2,8,K,28.57064717027596
40498,2068,8,2,10,K,28.76268660602457
93975,2068,5,3,8,J,29.053593337357828
68824,2068,4,0,4,M,28.710695450237758
81608,2067,4,2,6,E,29.19282412841119
78084,2068,4,1,5,Q,29.158884921188925
30554,2068,3,7,10,L,28.76257115800632
46834,2067,4,0,4,N,29.39619897701096
107762,2067,6,0,6,E,29.10317102980875
115896,2068,5,2,7,E,28.646303566316377
64862,2068,4,1,5,N,29.05284419570629
57565,2068,2,1,3,M,28.999463587925653
88275,2067,3,1,4,M,28.98323648311
34471,2067,5,1,6,E,29.474675713363887
137363,2068,4,0,4,E,28.51681602904444
39739,2067,7,0,7,M,28.977986700367705
164825,2067,6,2,8,J,28.973938270385865
39925,2067,9,3,12,D,29.228610515032454
16468,2068,7,2,9,N,28.776917051101982
148387,2068,4,2,6,N,28.705516579554317
113569,2068,5,2,7,M,28.80307663790053
135350,2067,3,2,5,D,29.02375992248456
55451,2068,3,1,4,S,28.865371300399413
41918,2068,6,1,7,G,28.60491455363416
110800,2067,2,2,4,J,29.11503452649756
180573,2067,5,1,6,Q,29.28111306341172
147387,2067,7,1,8,P,29.26809542755077
142033,2068,6,1,7,E,28.583546428669813
59517,2067,1,2,3,D,29.10896593682171
170268,2067,3,1,4,N,29.112337808207343
26599,2068,6,2,8,E,28.91565616976692
111055,2067,2,1,3,D,29.120809796242124
181054,2067,6,1,7,D,28.785042716839083
113098,2068,5,0,5,Q,28.983550203378037
67384,2068,3,2,5,E,28.9587691012816
109091,2067,5,0,5,E,29.22699328408011
112711,2068,6,0,6,E,28.82541297974999
103352,2068,5,2,7,M,28.63882255173844
96639,2068,5,0,5,D,28.89712820297513
67739,2067,2,3,5,E,29.34446424870811
26555,2067,5,0,5,J,29.271727787730587
143401,2067,6,1,7,N,29.25800642241694
109532,2068,5,3,8,E,28.78049045713861
78906,2068,6,0,6,Q,28.874343207647907
77590,2067,4,1,5,P,29.435155799694947
135278,2067,2,2,4,M,29.243593616024253
86939,2068,2,2,4,J,29.17878449439886
134769,2067,1,2,3,P,29.06027707553956
137292,2067,5,2,7,P,29.12480575445032
106504,2067,5,0,5,E,29.26492906977584
49792,2067,5,2,7,D,29.09392385527522
157324,2068,5,3,8,F,28.5828970271394
178202,2067,2,2,4,P,29.31619045233185
72388,2067,3,2,5,D,29.23910866970209
59659,2068,2,1,3,J,28.80898519787521
77215,2067,4,1,5,E,29.08476122179148
91607,2068,14,5,19,Q,28.812753431762424
44426,2068,5,2,7,N,28.69736986732798
174247,2067,6,1,7,J,29.004929149386854
94872,2068,2,2,4,A,28.59252267943982
142585,2067,1,3,4,N,29.284081269465315
165687,2067,5,1,6,J,29.156459380184508
17035,2067,5,2,7,Q,28.972676520844345
118478,2067,13,2,15,N,29.211008473274774
63183,2067,4,3,7,E,29.05453643600592
38346,2068,3,3,6,J,28.922486462077185
83257,2067,4,1,5,A,28.63775188249708
112200,2068,1,4,5,M,28.74047930933341
28003,2067,8,2,10,I,29.16737612650092
157451,2068,6,2,8,E,29.031156283822355
93552,2068,4,3,7,Q,28.825371286089823
158243,2067,2,0,2,N,29.17181141350053
127495,2067,4,0,4,A,29.127633434753932
146825,2067,2,1,3,M,29.25749035101868
57131,2068,3,3,6,S,28.955617552036863
174171,2068,6,3,9,J,28.9583318250503
96165,2068,4,3,7,N,29.111664442573225
119891,2068,5,0,5,N,28.73449253367285
28971,2068,3,1,4,J,28.874981587889447
130454,2067,3,2,5,M,28.96686682293211
45907,2067,5,2,7,D,29.73772406471032
131375,2068,5,1,6,N,28.893212892468032
85906,2068,6,1,7,E,28.75217451310948
134974,2067,6,1,7,J,29.21302555645244
60658,2067,12,5,17,D,29.736629007220348
96855,2068,3,1,4,E,28.771306886474974
44579,2068,2,1,3,P,29.134882155241822
53017,2068,3,2,5,E,28.71849358137867
136601,2068,4,1,5,N,29.150246833805053
151042,2068,7,3,10,M,28.66995649139396
143417,2068,4,0,4,P,28.70118972332776
130997,2067,5,0,5,K,29.05400530563248
140083,2068,3,2,5,E,28.59293319142848
85056,2068,4,2,6,J,29.04161140737482
182975,2067,1,1,2,D,29.19245748388916
33648,2067,6,0,6,M,29.226084356510107
143760,2067,6,2,8,F,29.58152381912452
147821,2067,7,2,9,M,29.108021148756865
156247,2067,3,2,5,P,29.450351926406853
147134,2067,3,2,5,M,28.928808640736488
146998,2068,5,2,7,N,28.99837648738036
136530,2068,6,0,6,M,28.5834855202677
19176,2067,5,2,7,N,29.319491232985285
54923,2068,4,3,7,N,28.85553075387608
52376,2068,1,2,3,I,28.83531552736997
133277,2067,5,1,6,H,29.15737535396048
143211,2067,6,0,6,P,29.233424114302053
136083,2068,3,2,5,P,28.606897609337068
99464,2068,3,2,5,N,28.946564258809847
159830,2068,3,4,7,S,28.64422010075442
107635,2068,3,1,4,E,28.78935345588817
147593,2067,4,1,5,D,29.477871636588628
160487,2067,4,2,6,Q,28.759783723985645
83222,2067,3,2,5,P,29.215432788638783
173180,2068,3,2,5,N,29.07623123322704
97716,2068,5,1,6,N,28.97306792846391
170937,2068,7,1,8,N,29.30415516700749
68071,2067,11,2,13,N,29.34335019908741
149968,2068,5,0,5,S,29.10776863773273
176954,2067,4,1,5,N,28.98953672658711
63866,2068,5,2,7,E,28.89770877663442
81855,2068,4,5,9,M,29.08294191667223
121315,2067,4,3,7,E,29.306571769222547
169379,2067,7,2,9,E,29.347165381051443
144889,2067,6,1,7,Q,29.06322176925488
139156,2068,4,3,7,E,28.72326649309924
148470,2068,6,1,7,M,28.521845865163456
98450,2068,2,1,3,N,28.7803597993368
135508,2067,2,2,4,S,29.49792425339525
18965,2068,7,2,9,E,29.032440396204148
45696,2067,2,1,3,S,29.43378981817049
17141,2068,5,1,6,E,29.041370283939106
104047,2067,4,0,4,K,29.183258146034383
78659,2067,4,2,6,M,29.07843563158216
114092,2067,2,1,3,J,29.209719450408095
92636,2067,7,2,9,E,29.08779052583489
85509,2068,2,1,3,E,28.999489449977915
136903,2068,3,1,4,M,29.082697456005643
92963,2067,4,1,5,N,29.263635170873865
166861,2067,5,0,5,S,29.176765308521755
38795,2068,4,2,6,R,28.94273487166314
52039,2067,4,2,6,K,29.223876069433278
129516,2068,5,6,11,M,28.91448199403419
173219,2067,0,3,3,Q,29.175618785654432
31728,2068,4,2,6,E,28.662449801023534
130287,2067,5,2,7,E,29.063628504139604
113992,2068,6,1,7,E,28.92097434823761
143864,2068,8,1,9,N,28.553071553948016
37922,2068,7,2,9,E,29.14836003335516
75059,2067,4,2,6,Q,29.08623915579242
63587,2068,4,0,4,E,29.07290933930083
170589,2067,3,1,4,K,29.32724972922053
144414,2068,0,4,4,J,28.71709460841138
95482,2068,7,2,9,Q,29.0823366708072
118836,2067,2,3,5,N,28.92123178132024
101665,2067,6,2,8,Q,29.41022040946993
15854,2068,6,1,7,P,28.38445770078957
120003,2067,30,4,34,E,29.02792046490235
106013,2068,6,3,9,K,28.674114092283745
101611,2067,6,1,7,E,29.32167704329601
133444,2067,5,2,7,P,29.20472707106409
72310,2067,2,2,4,E,29.21350916063879
51425,2068,5,2,7,Q,28.742747821519643
123534,2068,5,2,7,D,29.02093629284233
20023,2067,4,1,5,E,29.291165281595223
128981,2068,2,1,3,E,28.897495726929915
125036,2067,4,0,4,E,29.531486125013583
115916,2068,3,1,4,M,28.76227418687488
81638,2067,5,4,9,J,29.269102654002246
112356,2067,5,2,7,E,29.546167655858305
20129,2067,5,2,7,J,29.169076122626983
77614,2067,7,2,9,J,29.02395878189977
117639,2067,5,1,6,K,29.17102763835196
29673,2068,8,0,8,K,28.670001002212203
16500,2067,5,1,6,M,29.194330101842617
21164,2067,5,2,7,P,29.33290593659633
148812,2068,7,0,7,M,28.70257517602977
114845,2068,3,0,3,E,28.913384427955584
150772,2068,4,2,6,M,28.571641401479447
101203,2067,4,1,5,N,29.38677604629397
112733,2068,4,1,5,E,29.028962028609367
182915,2067,6,0,6,M,28.988357664143383
148512,2068,6,2,8,M,29.00336735761512
72326,2068,4,1,5,J,28.795303516236316
98807,2067,6,2,8,E,28.95555665424648
25215,2067,3,1,4,Q,29.523101411493293
81241,2068,6,2,8,D,28.8585621777199
75190,2068,6,2,8,Q,29.038279873094798
157665,2068,4,1,5,J,29.030754744108854
29115,2068,8,2,10,Q,28.825331298782075
107042,2067,4,2,6,J,29.39029841121973
116913,2068,4,2,6,K,28.845438203704926
62986,2068,6,0,6,D,28.86648908040315
46399,2068,5,0,5,J,28.83234820133214
124305,2067,6,3,9,K,29.389492564223232
18806,2068,7,2,9,P,28.841897208151323
83100,2067,3,1,4,D,29.194121790798032
167327,2068,8,0,8,M,29.07219319011244
149019,2068,2,5,7,M,29.110287185246232
33448,2067,6,2,8,J,29.334015859764083
57106,2068,3,2,5,Q,28.979768175158927
92865,2067,3,2,5,N,29.087595574823432
130472,2068,4,3,7,E,28.732190866141742
179267,2068,3,2,5,P,28.96154608485704
34498,2067,4,1,5,N,28.93833775314864
41597,2067,4,2,6,C,29.532723491079327
63774,2068,10,2,12,D,28.490544652006005
18281,2068,5,1,6,S,28.39150254520775
107725,2067,5,1,6,P,29.29591304729299
151462,2068,5,2,7,M,29.015980540945677
26863,2068,6,0,6,D,29.02667569253576
181814,2067,5,2,7,D,29.152247440263583
102123,2067,6,1,7,Q,29.019028650845478
25255,2067,5,1,6,C,29.00817715061273
129584,2067,2,1,3,S,29.1228181372122
98610,2068,1,2,3,P,28.6133325995917
110876,2068,6,2,8,N,28.30989180212868
174523,2068,5,1,6,N,28.70837737169547
102470,2067,5,1,6,P,29.59654737648266
106573,2068,5,1,6,N,28.68227636435176
38512,2068,5,2,7,I,28.70468937741417
41105,2067,4,4,8,J,29.12545330893432
148548,2067,6,2,8,M,29.149296176943704
131406,2068,4,1,5,M,28.844950233153664
29551,2067,2,2,4,S,28.884316014838475
46336,2068,2,2,4,E,28.961186839700925
58705,2067,5,0,5,E,28.95533973406716
40128,2068,3,2,5,I,29.287449066804577
31644,2067,5,0,5,J,28.744186415657065
85305,2067,6,2,8,E,29.444671786118928
117235,2068,1,2,3,R,29.05886986048735
51206,2068,5,2,7,F,28.766510979183103
128805,2067,5,2,7,J,29.202480503921837
140163,2067,5,2,7,J,28.87775315488876
135521,2068,2,2,4,P,28.78929910061566
97941,2067,3,3,6,E,29.123749668684663
175028,2067,1,2,3,S,28.7833973846771
134901,2067,2,0,2,N,29.07846682577095
88082,2068,4,2,6,E,28.89911048830804
51373,2067,2,1,3,N,29.6672681195686
25881,2068,2,1,3,Q,28.83321178771764
136761,2068,2,1,3,P,28.88365441079126
122769,2067,7,2,9,K,29.065818834073475
159522,2067,5,1,6,I,29.074061057849413
38211,2067,5,2,7,A,29.03193490017799
157219,2067,5,2,7,A,28.87798481123536
37305,2067,6,3,9,E,29.16554526719048
177293,2068,6,0,6,J,29.103852592986424
127480,2067,6,0,6,J,29.194119214330232
40472,2068,6,1,7,K,28.552903629012988
115734,2067,4,1,5,Q,29.38558272577417
64257,2068,7,1,8,M,28.910259959683813
76301,2068,6,1,7,M,28.96704854995169
116265,2067,4,1,5,J,29.091580621409125
165703,2067,5,6,11,I,29.228217269233223
41905,2067,5,1,6,M,29.287894824375453
55791,2068,6,0,6,J,28.892076767586317
98922,2068,5,1,6,E,28.70550359150504
62843,2068,2,2,4,J,28.77250995792187
102684,2067,5,0,5,Q,29.4042952671286
141760,2067,6,1,7,E,29.495344086487968
81251,2068,4,1,5,D,28.69538372537033
128150,2067,4,1,5,P,29.12031314720243
179165,2067,5,0,5,E,29.01500255899211
177541,2067,5,1,6,M,29.3699333284163
175846,2067,5,2,7,Q,29.18250176106505
55240,2067,6,0,6,Q,29.071509572088942
56739,2068,5,1,6,M,28.613807824697453
82517,2068,6,1,7,N,28.975703285970415
161905,2068,3,3,6,E,28.617950829217488
56790,2067,12,3,15,M,29.102081609107746
69234,2068,4,2,6,N,28.726994379704248
49944,2067,4,1,5,E,28.90688336345801
134698,2068,4,1,5,J,28.522624597304265
162800,2068,6,1,7,M,28.72334498560813
64711,2067,9,0,9,D,29.170419410104262
96224,2067,8,2,10,J,29.10881830687224
170309,2068,5,1,6,N,28.81295907045503
182848,2068,5,2,7,R,29.09031272333962
42643,2068,5,0,5,J,28.71163010607698
49080,2068,9,2,11,H,28.76687773390081
40739,2067,5,2,7,A,29.120699895545123
156497,2068,6,2,8,E,29.075215524329387
65846,2068,4,1,5,E,28.983071968001013
144078,2068,4,1,5,N,28.686471549636323
95459,2067,4,2,6,L,29.10751095171642
33375,2067,8,2,10,N,28.943205581190952
27752,2068,9,2,11,E,28.81085834908376
54951,2068,6,0,6,M,29.194151753902663
27583,2067,5,0,5,K,29.54128057933169
15750,2067,6,2,8,J,29.189660524085845
41581,2068,4,2,6,E,28.80147461350434
59962,2067,3,1,4,E,28.94683002040225
125446,2067,3,2,5,M,29.295928796576742
74852,2067,4,0,4,M,29.01097876251005
167558,2067,4,1,5,C,29.339718750014136
146928,2068,4,2,6,P,29.026149473841382
19134,2067,7,1,8,N,29.05435052365082
115228,2067,8,1,9,I,28.90912212870911
127514,2067,4,1,5,E,29.25550081035418
61752,2067,6,1,7,P,29.356761557131115
20519,2068,3,2,5,K,28.78498462891603
138454,2067,4,1,5,M,29.10104825489464
156802,2067,5,2,7,Q,29.3000515720528
143092,2068,7,0,7,Q,29.06926359515576
150055,2068,5,0,5,M,29.02720203038573
51811,2068,6,0,6,N,28.92371120505408
33901,2067,1,2,3,M,29.30133432829281
22077,2067,3,1,4,N,29.19098182160919
143566,2068,6,1,7,P,28.618036145446823
104201,2067,6,2,8,P,28.888136401641887
45003,2067,2,2,4,S,29.14330474199736
120812,2067,5,3,8,E,28.9994591918312
142851,2068,1,4,5,M,28.386307311583955
28677,2068,5,1,6,Q,29.0425905804636
49031,2067,2,3,5,Q,29.226392195637537
182241,2067,9,5,14,F,29.072424454236696
177481,2068,8,5,13,E,28.882684583150183
157482,2068,1,1,2,P,28.96636376548881
28529,2067,3,2,5,E,29.16828595173433
139650,2068,7,0,7,M,28.95582445494594
157292,2067,5,2,7,D,29.21283072917562
120126,2068,5,2,7,M,28.86367423680445
77142,2068,2,1,3,L,29.2067001123116
58882,2068,4,1,5,D,28.92438326799798
46834,2068,4,0,4,N,28.86954533533498
48108,2068,9,1,10,E,28.528474081951053
93311,2068,13,1,14,E,28.89964870534792
111938,2068,11,3,14,P,28.72266846904603
54831,2068,5,0,5,M,28.9706878904689
27325,2067,4,1,5,P,29.13599485747836
37204,2067,5,0,5,K,29.012862691027436
156610,2067,2,1,3,N,28.77849062302193
65517,2068,5,0,5,H,28.882131389452088
89263,2068,4,3,7,C,28.627367737921546
142687,2068,1,1,2,N,28.82884736673344
66129,2068,2,3,5,N,28.8209047782379
112057,2068,3,0,3,N,28.746367814414796
143196,2067,5,2,7,M,29.59983229576757
171170,2068,4,0,4,A,28.922716865949692
182681,2068,2,1,3,M,28.666198061104428
84087,2067,1,4,5,I,29.01992656584416
147229,2068,9,3,12,D,29.111318152449847
62558,2067,3,1,4,P,29.20971168095103
109064,2068,2,1,3,Q,28.814454534596337
77698,2067,5,1,6,E,29.21203884985809
63754,2068,2,1,3,D,28.87592899025441
73133,2068,6,2,8,N,28.57288540627548
130662,2068,4,3,7,M,28.794815149140582
71862,2067,4,3,7,S,29.044821862032776
117789,2068,3,3,6,D,28.82874020850108
56303,2068,1,3,4,E,28.69829515885748
143399,2067,22,2,24,P,29.418534237438926
82745,2068,6,2,8,Q,28.532674654808325
63074,2068,2,1,3,N,28.87227866780737
106680,2068,6,1,7,N,28.846320819425586
60334,2067,4,1,5,M,29.24294696808057
118334,2068,3,2,5,N,29.18773305816517
17362,2068,16,2,18,F,28.73180521575325
140505,2067,7,0,7,E,29.27904944671925
114252,2068,8,3,11,A,29.13261991317353
173499,2067,7,4,11,F,29.168625374167025
137431,2068,4,0,4,K,28.662216082046392
169802,2068,4,0,4,J,28.840593561043665
94006,2067,1,3,4,D,28.951710960571997
19999,2068,2,1,3,H,29.029659948106463
158853,2068,3,1,4,D,28.800168167547675
73729,2067,3,2,5,K,28.823884021261488
112639,2068,3,2,5,Q,29.00209247187997
170701,2068,8,0,8,E,28.930084738096895
131201,2067,3,1,4,J,29.164308493786297
59371,2067,2,2,4,J,29.167996843627964
147422,2067,4,0,4,J,29.393174572227657
176805,2067,4,4,8,N,28.99192923649118
61582,2068,4,3,7,E,28.945689064604974
146901,2068,5,2,7,Q,28.66705157424597
165522,2067,2,0,2,M,29.30529594735101
178784,2067,7,1,8,M,29.08108778800933
101124,2068,7,4,11,F,28.82945815895221
172415,2068,0,3,3,J,28.64292090046545
17473,2068,7,2,9,A,28.950441366432628
89906,2067,6,1,7,M,29.48588658811445
61232,2068,3,1,4,M,28.971117343574008
134229,2068,4,3,7,N,28.793278290467853
66978,2067,4,1,5,J,29.35847776243079
158957,2068,5,2,7,M,28.89209240008072
61991,2067,3,1,4,Q,29.00489746373659
130278,2067,4,0,4,J,29.061736641724
99616,2067,7,0,7,N,29.26845756008859
97580,2068,4,0,4,N,28.713449702768425
26809,2068,5,0,5,Q,29.148449803751305
88605,2067,7,2,9,D,29.26705990984177
160054,2068,5,0,5,E,28.787190202875717
133694,2067,8,2,10,Q,29.570336037731995
116183,2068,7,2,9,S,28.96132579930189
82293,2067,5,1,6,N,29.04555937255742
161658,2068,3,2,5,N,28.95885617554752
155933,2068,3,0,3,P,29.252923941863244
23576,2068,7,0,7,P,28.859004633657182
145480,2067,6,2,8,M,29.016754486032603
117566,2067,7,0,7,E,28.995904798128645
156441,2068,2,3,5,R,28.7579950881671
82445,2068,5,1,6,E,28.725908189021837
150966,2068,3,1,4,M,28.709823411253836
148141,2068,3,0,3,J,28.86211700814819
113655,2067,15,4,19,E,29.06081443515904
21669,2067,5,2,7,Q,28.920983272277148
34327,2068,5,0,5,E,28.55455701355259
41601,2067,7,0,7,M,29.280459049062245
37970,2067,3,1,4,D,29.15306154510604
160907,2068,4,1,5,Q,29.23441219537052
174403,2068,6,1,7,N,28.957730278761908
159805,2067,3,2,5,K,29.27078230992593
26822,2068,5,1,6,N,28.700573736481235
53460,2067,6,2,8,P,29.425835751622788
69186,2068,5,1,6,E,28.956250079556547
39591,2067,6,2,8,K,29.329428651349456
148867,2068,7,0,7,P,28.9376678311315
105821,2067,4,2,6,M,29.196122413038704
103108,2067,3,1,4,P,29.073501760271277
147115,2068,7,0,7,S,28.83563357398824
159438,2067,3,1,4,D,29.132187546215
77772,2067,5,4,9,F,29.35234456191977
136290,2067,4,1,5,M,29.35758470025045
182146,2068,6,0,6,M,29.09102140949826
143418,2067,4,2,6,Q,28.980919552660225
85584,2067,5,2,7,N,28.916927005711493
63089,2068,3,4,7,N,28.917028252083245
54111,2068,5,2,7,E,28.68840581564353
57539,2068,5,2,7,Q,29.15663080195223
167365,2067,7,0,7,M,29.21601886305381
17707,2068,4,1,5,E,28.816860367118025
158811,2067,4,1,5,S,29.370218646604204
124051,2068,8,1,9,E,28.54961045168757
107496,2068,5,2,7,K,28.72290602180387
149364,2068,5,2,7,N,28.602678650219115
46242,2067,6,1,7,E,29.398043023851663
78546,2067,4,1,5,E,29.532540697193955
34271,2068,6,2,8,E,28.752872314818863
177076,2067,3,3,6,N,29.12619524119664
34111,2068,6,0,6,Q,28.96921196904062
112179,2068,3,1,4,E,28.79158211344328
160054,2067,3,0,3,E,29.231987264048424
95481,2068,40,0,40,N,28.649808880777805
101810,2067,4,2,6,E,29.21940900703131
41750,2068,3,0,3,J,28.4469790865898
139729,2068,4,1,5,C,28.69298372853109
167512,2068,4,0,4,S,28.94294241694731
141380,2068,7,1,8,M,28.89012444020053
114566,2068,3,0,3,M,28.8575867265516
107628,2068,2,3,5,P,28.94900058875688
135845,2067,6,0,6,J,29.11025740583771
137739,2068,4,1,5,M,28.584505205038347
102877,2067,6,0,6,N,29.2100266941911
129107,2068,6,0,6,Q,28.739003668205864
54766,2067,2,3,5,S,29.419675123805536
63022,2068,6,0,6,E,28.644502934043462
179827,2068,6,1,7,A,28.754143757076097
140642,2068,6,2,8,M,28.8790292149858
77949,2067,1,2,3,M,29.29273944731449
27743,2067,1,3,4,D,29.20390424070337
37702,2068,5,2,7,P,29.16467617448863
56787,2067,3,3,6,M,29.424952181926333
28694,2068,3,3,6,D,29.05691693323156
63213,2067,6,2,8,E,29.078116688863066
69469,2068,7,0,7,N,28.61422874634177
164904,2068,6,2,8,C,28.863929685244727
115465,2067,5,3,8,I,29.019598175576064
100849,2068,2,3,5,P,28.90236106957136
97791,2067,3,6,9,F,29.16515620140896
145660,2067,9,1,10,P,29.49786680760419
92585,2068,5,1,6,N,29.034901358400717
182010,2068,6,0,6,R,28.863576185404156
137759,2068,5,1,6,N,28.7874896904083
73417,2067,4,0,4,E,29.191820695502244
92272,2067,5,0,5,N,29.16514658664483
98205,2067,4,2,6,N,28.86972167081308
54215,2068,8,0,8,N,28.822085912778714
131933,2067,3,1,4,J,29.071684727235912
85167,2067,5,0,5,N,29.29148776604728
144005,2067,5,0,5,C,29.07697038738472
92264,2068,4,0,4,E,28.92978895600693
150790,2068,2,0,2,M,28.74467407512789
79429,2068,4,1,5,M,29.0005283313203
59143,2068,5,0,5,D,28.44760912738688
62063,2067,3,0,3,P,28.925052326387256
174376,2068,4,0,4,Q,28.75944972063768
173238,2067,6,1,7,E,29.72386475598892
48649,2067,4,1,5,J,28.949958596699396
24575,2068,3,0,3,K,28.88418661379379
164352,2068,5,3,8,S,28.961353376411115
59193,2068,3,2,5,N,28.87630114256164
65302,2067,5,0,5,N,29.10262016613163
17650,2067,5,2,7,J,29.40420862779048
174652,2068,7,1,8,E,28.83604496297665
86797,2068,5,1,6,E,28.93016246269992
48361,2068,3,1,4,K,28.833443620569856
77546,2067,6,0,6,F,29.046253127230152
138208,2068,8,2,10,N,28.79588146263817
20489,2068,5,1,6,P,29.15927148011552
117517,2067,6,3,9,P,29.232393079076424
132782,2067,1,1,2,E,28.77951208318295
55328,2067,3,0,3,Q,29.14956182024297
40381,2067,7,1,8,E,29.234378790531743
182393,2067,5,2,7,M,29.06057701034574
115409,2067,6,1,7,E,29.037621483824637
59070,2068,6,2,8,N,28.79246081447463
119109,2068,5,4,9,A,28.887202964496783
75995,2068,4,2,6,M,28.71023567796096
22069,2068,8,1,9,Q,28.779349935664293
134945,2068,7,1,8,P,28.95729485711387
134034,2067,3,2,5,D,29.347628873042908
103240,2067,13,6,19,P,28.85297054225674
51259,2068,5,2,7,Q,28.86245399080551
118198,2067,6,0,6,M,29.02774254397629
36961,2068,5,1,6,Q,29.403808284107463
178142,2068,6,1,7,M,28.82567313699737
141612,2068,3,3,6,P,28.89599670571293
149368,2068,6,1,7,Q,28.33111800056425
81380,2068,5,0,5,K,28.72670358812149
132507,2067,2,3,5,E,29.060789573864817
75474,2068,5,2,7,E,28.98635626107369
94003,2067,3,1,4,J,29.015603097411656
137308,2067,4,1,5,P,29.34298729412652
135734,2068,5,1,6,M,29.155669943480323
19834,2068,7,0,7,D,28.59791023740207
162533,2067,4,4,8,M,29.06791245400141
139744,2068,3,2,5,E,28.58858946672246
65066,2067,3,1,4,K,29.583053939493094
60650,2068,6,1,7,R,28.637569162288912
98897,2068,5,1,6,D,28.91082184021857
172607,2068,7,0,7,N,28.87658067628145
94577,2067,4,2,6,J,29.186872371645755
134824,2067,3,1,4,J,29.13649848402757
18980,2068,7,2,9,J,28.90107660330997
99751,2068,2,0,2,K,28.86456164407851
176091,2067,6,2,8,P,29.03778196898558
136293,2068,5,3,8,J,28.81642313313547
100969,2067,5,4,9,N,28.948232253184784
27926,2068,5,0,5,J,28.5323253862102
145185,2067,5,2,7,D,28.93482040102256
63213,2068,7,2,9,E,28.971844926116574
17305,2067,0,4,4,E,29.482234676830178
175519,2068,6,0,6,P,28.88901240924032
27176,2068,5,1,6,D,28.78584217114788
92164,2068,7,3,10,D,28.54938980946648
34479,2067,3,1,4,J,29.01390532314312
159023,2067,2,2,4,D,29.32777126852573
111639,2067,4,2,6,M,29.133005656380934
79184,2068,4,2,6,N,29.1330663640646
78385,2068,4,2,6,N,28.652905903352693
146289,2067,6,1,7,M,29.337867768488398
52302,2068,6,2,8,K,28.929911775573608
40380,2067,6,0,6,M,29.312041572205803
78364,2068,7,2,9,P,28.83679377435278
53017,2067,5,1,6,E,29.040461381815536
115070,2067,4,1,5,E,29.33282026617721
149148,2068,1,3,4,M,29.184685526712133
77590,2068,4,2,6,P,29.021876568790784
128805,2068,4,1,5,J,28.713965758653387
143960,2068,2,3,5,E,29.113800595603603
106041,2068,2,3,5,P,29.016803991952397
126113,2068,1,5,6,M,28.69739482948153
174441,2067,0,3,3,N,29.27246194630768
30034,2068,7,5,12,M,29.28815344574142
146524,2068,5,1,6,P,28.68434855014554
141488,2067,4,0,4,E,29.138045118752604
29986,2067,5,0,5,E,29.20743459856563
75704,2067,5,2,7,S,29.497243429628934
93490,2067,4,2,6,D,29.21488128743981
59788,2067,3,2,5,E,28.86925792839814
21805,2068,2,1,3,M,28.85377834645272
97920,2068,13,3,16,E,28.700235831338727
93156,2067,10,2,12,J,29.45891748892131
158431,2067,3,1,4,E,29.35035245509216
176125,2067,6,1,7,E,29.263331133489665
118633,2067,2,2,4,K,29.177364547954003
146693,2067,3,2,5,P,28.830757030906327
63260,2068,4,2,6,Q,28.786678889875887
131365,2067,4,0,4,K,29.19794817478353
90637,2068,4,1,5,K,29.125801047065675
104148,2068,5,0,5,M,28.723942674778733
16738,2068,3,0,3,J,28.92265990832612
162800,2067,3,1,4,M,29.43335627290935
18546,2068,5,1,6,E,28.90297826932998
143591,2068,3,2,5,J,28.560440887023507
65398,2068,5,0,5,H,28.74311276652548
29218,2068,4,0,4,K,28.9380454420478
60118,2068,7,0,7,D,28.73301781764168
91665,2067,3,1,4,D,29.07347945457137
144474,2067,2,3,5,F,29.08899813988585
41399,2068,4,0,4,J,28.9630358626578
128220,2067,5,1,6,K,29.073135000134805
146294,2068,5,1,6,E,28.859385413759632
132108,2068,6,3,9,K,28.91149516987553
77716,2067,6,3,9,Q,28.715265312770956
133325,2067,7,2,9,E,29.08958797954985
144751,2068,5,3,8,M,28.864543084349098
145798,2068,2,3,5,I,28.60573797375104
57596,2068,4,2,6,M,28.93798334288968
27999,2067,2,2,4,E,29.122508733048804
115590,2067,5,1,6,P,29.14548938498991
45932,2067,2,3,5,J,29.544276315060667
100733,2067,4,0,4,J,29.089801052632097
110916,2068,3,2,5,P,28.81950462292808
74018,2068,3,0,3,R,28.63199567477353
93044,2067,8,2,10,N,29.26187551829656
127136,2067,0,3,3,E,29.18239603821296
51827,2067,6,0,6,P,29.116639767197515
175334,2067,2,0,2,P,29.440918226527018
107570,2067,6,2,8,N,28.887423214448088
55949,2067,1,2,3,J,29.4688433021412
77271,2068,2,3,5,M,28.45847092555926
114408,2067,6,0,6,K,28.93495684524126
113572,2068,2,4,6,E,28.704416769813346
176729,2067,1,2,3,N,29.265722907810208
124488,2067,9,1,10,Q,29.228000555188345
164109,2067,2,2,4,E,29.160158647205183
58878,2067,3,0,3,Q,29.050658562606305
70568,2067,6,2,8,E,29.07991494419002
65355,2068,3,0,3,J,28.640019400388272
65871,2068,5,2,7,E,28.998594087740138
124005,2067,2,0,2,J,29.22202031673405
44900,2068,7,2,9,H,28.763153243456205
141909,2067,5,2,7,E,28.926708800424468
158588,2068,8,4,12,D,29.10490144532717
29258,2068,4,1,5,E,29.10047751747957
112431,2067,3,1,4,M,29.10146702052676
144415,2068,2,2,4,A,28.73887521916778
140014,2067,2,0,2,M,28.95313482060275
135291,2068,4,0,4,Q,28.76125101605502
182622,2068,2,3,5,G,28.924244349963956
149473,2068,2,3,5,Q,28.870538480354657
89145,2067,4,3,7,S,29.273402854344457
33757,2068,2,1,3,M,28.843655544226248
167379,2067,2,4,6,F,29.348932292554803
103240,2068,11,4,15,P,28.74368725793926
41941,2067,5,3,8,K,29.300837442263003
171873,2068,2,0,2,E,28.999082168884485
92022,2067,6,2,8,D,28.722627830682
49510,2067,3,1,4,Q,29.20080868290208
92180,2068,4,2,6,E,28.75620103958047
26850,2068,6,0,6,C,28.77017100103006
17166,2068,4,2,6,D,28.91320845563733
117130,2068,6,0,6,K,28.876063410660286
108760,2067,5,2,7,F,28.92829924597206
45011,2067,3,1,4,N,29.100433983802443
62646,2068,4,0,4,P,29.10976133762137
162350,2067,2,1,3,E,29.38372511409988
92083,2068,5,0,5,N,29.04720102838803
83755,2067,4,1,5,C,29.026689470118427
146992,2068,8,1,9,E,28.913789467220862
145972,2067,2,1,3,M,29.089589485014304
100299,2067,5,3,8,J,29.488247871959583
127796,2068,1,1,2,J,28.87856477194938
127873,2068,6,3,9,P,29.15739524051912
26058,2067,5,2,7,Q,29.046782252355133
81843,2067,5,0,5,E,29.060734008175988
127355,2067,2,2,4,J,29.28253392754452
33483,2068,7,0,7,C,28.682185881488003
117065,2068,0,5,5,D,28.91088742965439
48760,2067,8,1,9,A,29.198915909962544
70344,2068,4,2,6,E,28.81814460369698
63271,2067,4,0,4,Q,29.32540544128624
157030,2067,5,1,6,D,29.31531153843292
163039,2067,1,1,2,N,29.27916979463946
37602,2067,2,1,3,F,28.71408571798924
150299,2068,5,0,5,M,28.89826024388941
82682,2068,4,2,6,N,28.807517383871296
42856,2068,3,2,5,J,28.935163885945155
172888,2068,3,1,4,Q,28.82134947825653
96508,2068,7,1,8,K,29.167966464365144
119838,2067,24,11,35,E,29.154066418052125
25313,2068,3,0,3,D,29.140046457722228
111405,2068,2,1,3,P,28.81341162960761
179091,2068,1,2,3,M,28.83494444085921
103163,2068,3,0,3,K,29.09579445998324
129310,2067,2,3,5,K,29.265966701392305
105721,2067,4,2,6,N,29.238299529924152
161570,2067,3,5,8,I,29.37814299702033
58749,2067,10,3,13,Q,29.420054752710943
47692,2067,1,4,5,P,28.957371610338345
32076,2068,9,1,10,E,28.517101752049843
78053,2067,8,1,9,N,28.915584088187774
117861,2067,6,2,8,D,29.16025134604073
102603,2068,5,0,5,N,29.20600015540277
160386,2068,7,1,8,D,28.94318971221733
144246,2067,4,2,6,M,29.50712011094677
127690,2067,5,1,6,M,29.088748273004526
166598,2067,6,1,7,P,29.166597351518384
63685,2068,3,1,4,K,28.90053858732205
148032,2067,8,2,10,P,28.99447842449432
157438,2068,4,0,4,N,28.867868396721256
107336,2067,3,2,5,S,29.1391918788632
119126,2067,6,0,6,E,29.23631051163041
121069,2067,6,3,9,E,29.131151068336013
20771,2068,3,1,4,Q,28.76934743480425
93629,2067,2,1,3,Q,29.422644968768328
16441,2068,6,3,9,P,28.934449657050862
30465,2067,4,2,6,E,29.37980678636018
111690,2068,5,3,8,J,29.10094378188225
54750,2067,3,2,5,E,28.801497764113822
32908,2068,1,3,4,E,29.248622439257463
174303,2068,4,1,5,J,28.867822145494173
128899,2067,4,0,4,Q,29.30094198976505
62046,2068,3,2,5,E,28.81665469082914
160727,2068,4,3,7,N,28.860331910798152
130345,2068,9,1,10,P,28.69523843920728
62377,2068,5,1,6,E,28.57780655027741
169993,2068,5,2,7,N,28.84663750602169
77314,2067,8,3,11,I,29.1156547036848
180750,2067,3,1,4,K,29.07171238021058
124926,2068,4,3,7,P,28.436902902698236
45349,2068,3,2,5,E,28.92474923742357
59614,2068,8,0,8,D,29.026923531844066
88909,2067,8,0,8,E,29.147133479898848
62440,2068,5,1,6,M,28.696430147145605
26686,2068,2,1,3,E,28.96350799193421
137821,2067,5,3,8,I,29.393373183551805
98646,2067,1,2,3,E,29.26834122322257
51475,2068,2,0,2,D,28.82491449374699
158260,2068,5,1,6,Q,28.777743782643324
20118,2068,3,3,6,E,28.60726438004506
55295,2068,3,2,5,N,28.94954483239646
147673,2067,3,0,3,K,29.07358314427264
109797,2068,4,1,5,E,28.82234660519087
42312,2068,3,0,3,P,28.67672977800414
160679,2068,5,1,6,N,28.668982770727883
39400,2068,2,0,2,P,28.74267511843436
145037,2068,6,1,7,K,28.706265328778706
110524,2067,5,0,5,E,29.31902325099494
105054,2068,2,1,3,J,28.818100743907607
112111,2068,5,2,7,K,28.80035939587032
178570,2067,5,0,5,H,29.156745960680222
108963,2067,4,2,6,K,29.505980872261738
81442,2068,2,1,3,J,28.85727179270173
29413,2067,2,1,3,E,29.373585199470316
78041,2067,5,1,6,D,29.25123685249684
77342,2067,5,2,7,N,29.286923108930612
54549,2067,5,4,9,P,28.912720672335126
156503,2068,5,0,5,E,28.74835912513541
149177,2068,5,2,7,M,29.104073059201195
139971,2067,5,1,6,N,29.065043452191063
123385,2067,6,1,7,M,29.455558014046296
29964,2068,6,2,8,P,29.06981687681935
95117,2068,4,1,5,N,29.021710775320766
75705,2068,4,4,8,M,28.84494027407464
121909,2067,3,3,6,E,29.19411498037089
77894,2067,4,1,5,E,29.32914323028596
48069,2068,3,2,5,E,28.579145109772828
22650,2068,4,2,6,N,28.6747914886712
55857,2068,6,2,8,J,28.90810328620615
45240,2067,4,2,6,A,28.98796948172224
182336,2067,4,2,6,J,29.20460818059079
179068,2067,7,2,9,E,29.047248071064438
48924,2068,8,0,8,F,28.883512708398182
65167,2067,4,0,4,D,28.96118010582474
156629,2068,3,3,6,N,29.255746750083155
181719,2068,11,1,12,P,28.853569565714444
46121,2067,4,1,5,J,28.95686165455159
124978,2068,2,3,5,E,28.92803691868737
131798,2067,2,1,3,Q,29.37521113292445
157255,2067,5,3,8,M,29.000555755205337
134361,2068,8,1,9,K,28.675743756306385
159929,2068,5,1,6,E,28.985695279353184
88224,2067,2,1,3,S,29.15801508276809
38483,2067,5,1,6,J,29.287216948671546
114512,2068,4,0,4,Q,28.95020221852017
65116,2068,8,2,10,I,28.87020863909441
33749,2067,9,4,13,S,29.127904585136665
120285,2067,16,3,19,E,29.573899149799523
183082,2068,5,1,6,J,28.75651893183608
183083,2068,5,1,6,M,29.067230530531443
114312,2067,7,1,8,F,29.1876734333519
134291,2067,5,2,7,E,29.32010583416443
143340,2068,3,2,5,A,28.58324221746576
125542,2067,3,0,3,P,29.17967589093338
105147,2068,4,1,5,N,29.142138995443823
72766,2067,8,0,8,E,29.19271018150732
59593,2067,7,2,9,D,29.334932008641044
46912,2067,8,0,8,P,29.13817651569958
146517,2068,4,0,4,Q,28.834339714326607
123327,2067,8,0,8,N,29.26749023399032
130753,2068,2,2,4,J,28.974073374154365
98311,2068,12,2,14,J,28.660676864598376
145781,2067,2,0,2,M,29.15379038988759
18272,2068,5,2,7,D,28.590324855794226
78584,2068,3,0,3,M,28.6892353418372
46564,2067,2,0,2,J,29.068870273040183
65557,2067,14,1,15,J,29.27259262543417
167267,2067,1,2,3,S,28.97413089859
156469,2067,3,0,3,E,29.06434651910014
125621,2068,2,2,4,K,28.927369609607677
41573,2068,6,1,7,J,28.584079838049743
121502,2067,6,0,6,M,29.330317485160865
123186,2068,10,1,11,E,29.082336682124566
82001,2067,4,2,6,N,29.306220403845806
121212,2068,3,0,3,J,29.053439493157867
147600,2067,6,2,8,M,29.7192270311344
174121,2068,4,0,4,A,29.076030826809863
162404,2068,2,3,5,S,29.017124560983707
171261,2067,4,2,6,Q,29.33342359255779
69015,2068,6,0,6,E,28.761512616876747
26366,2068,4,3,7,I,28.876043387124582
175515,2067,2,0,2,D,28.959568285300627
174855,2068,6,1,7,P,28.71964501413737
29617,2068,6,2,8,J,28.87463802051497
74136,2067,5,2,7,D,29.23056179191653
63774,2067,7,1,8,D,29.07330419550107
65571,2067,8,3,11,I,28.998685614779475
94626,2067,3,1,4,J,29.2186824340627
94885,2068,8,2,10,J,29.074742088037137
134894,2067,2,3,5,Q,29.30847443073816
150906,2068,2,1,3,M,28.40647827817212
123563,2067,1,1,2,P,29.256103731850462
81644,2067,3,0,3,E,29.138105751353887
121501,2068,4,2,6,J,28.765509673241915
107537,2067,8,0,8,Q,29.36845104016968
144750,2068,3,1,4,M,28.70792005088584
129960,2068,4,2,6,N,29.05535865645161
61545,2068,6,0,6,H,28.70832359822901
59233,2067,6,1,7,N,29.34131074735157
143843,2067,6,1,7,P,29.68058009964491
86788,2068,1,1,2,J,28.89313344130736
163465,2068,6,3,9,P,29.10374243300876
77585,2067,5,0,5,Q,29.238828279570637
169379,2068,3,0,3,E,28.737691801255497
16145,2067,11,0,11,P,29.07536326481692
110481,2067,2,1,3,M,29.15049151485272
81288,2067,6,2,8,S,29.476976031167013
143063,2068,5,1,6,E,28.93202682704377
115097,2067,7,0,7,E,29.371419541127747
146916,2067,6,1,7,A,29.433301754114986
88534,2067,6,2,8,A,29.3402262846492
160541,2068,7,3,10,P,28.659065011724483
64972,2067,4,1,5,C,29.38272120582853
46982,2067,2,0,2,J,29.16125209855073
15974,2068,5,3,8,J,28.897613870410343
120335,2068,5,3,8,N,28.97433017690288
157711,2067,3,1,4,N,29.108376397569984
66292,2067,5,0,5,P,28.8266262783151
114097,2068,6,1,7,E,29.053803191528772
109933,2067,2,2,4,K,28.89753913614591
165877,2068,6,0,6,M,29.00248343054731
72565,2068,7,2,9,E,28.758965651101946
45392,2068,4,1,5,E,28.89050908263126
110131,2067,5,2,7,K,28.94466161273271
59505,2067,5,1,6,D,29.17169317634532
180693,2067,6,1,7,E,29.16875735211496
121710,2067,6,1,7,P,29.13004264601967
40431,2068,7,0,7,K,28.91285548470943
128162,2068,3,2,5,E,28.93398731903109
53148,2068,6,0,6,M,28.6847802868614
99348,2068,4,4,8,M,28.486232175497864
93409,2068,0,3,3,J,28.75405268118445
104569,2067,2,1,3,N,29.12966348629581
100690,2067,6,2,8,J,28.97479435175382
65379,2067,2,1,3,D,29.422539678184027
69255,2067,6,2,8,D,29.118762158157413
16004,2067,3,1,4,D,29.053410233772112
138433,2067,5,1,6,M,29.24734102063266
150028,2068,2,1,3,M,28.915074697532965
62805,2068,2,1,3,D,28.670802408153385
108508,2068,6,1,7,N,28.92310169305215
144929,2067,6,2,8,M,29.29673534840316
22626,2067,6,1,7,M,29.324140771150333
183442,2068,3,1,4,Q,29.120327894617542
146671,2068,7,0,7,N,28.782319176017715
136355,2067,5,1,6,E,28.960170198325088
158087,2068,3,3,6,M,28.5233925792565
145504,2067,7,0,7,P,29.201145393929917
46497,2067,9,1,10,R,29.31620110815983
145422,2067,3,2,5,N,28.99088389944408
157176,2067,2,1,3,D,29.1857156451855
76586,2067,4,2,6,N,29.22499108297133
48346,2067,3,1,4,Q,29.208842749078777
139784,2068,3,1,4,N,29.15949975462689
89709,2068,4,2,6,M,28.81306486847138
41542,2067,6,2,8,D,29.24501469389297
55397,2067,4,1,5,M,29.237203133120783
28571,2068,5,2,7,N,28.797918582934017
97566,2068,10,4,14,E,28.831677187368037
160825,2067,11,1,12,N,29.395506862934297
145157,2068,8,1,9,M,28.821663176884844
64816,2067,3,2,5,D,29.230292614293905
174875,2068,2,2,4,E,29.063669392386156
27831,2068,3,1,4,Q,28.765975909838712
169596,2068,2,3,5,N,28.997479889924843
110875,2067,5,3,8,S,29.271336666273328
54828,2067,2,1,3,M,29.166047850398197
178842,2068,6,1,7,E,28.941430794410543
148835,2068,2,0,2,Q,29.060445973925287
173329,2067,6,0,6,E,28.89773559598712
175544,2067,2,1,3,C,28.94465478168636
136178,2067,3,2,5,Q,29.199729608439263
172197,2067,3,3,6,Q,29.03063737059144
97262,2068,8,4,12,P,28.6758583516629
135816,2068,6,3,9,M,29.074770014501222
41227,2067,4,3,7,D,29.49905638525483
121045,2067,5,3,8,E,29.51540980390161
72340,2067,3,0,3,E,29.248453085161444
78731,2067,3,1,4,M,29.10863503702037
91732,2068,2,2,4,A,28.885933077688943
94875,2068,4,2,6,D,28.852324445550305
100675,2068,2,2,4,K,28.689198875325303
92976,2068,6,0,6,N,28.72485423250871
81736,2067,4,2,6,N,29.378870718527704
95031,2067,4,0,4,J,29.23326816993284
158651,2067,5,1,6,N,29.3808781725271
156977,2068,3,2,5,P,28.68047084744668
180022,2067,5,3,8,J,29.21529762286342
106842,2068,1,3,4,I,28.777920719245994
96356,2068,6,2,8,Q,28.724551212824355
62584,2068,4,2,6,J,28.8456389614794
54953,2067,5,0,5,N,29.324606863680724
77299,2068,9,1,10,A,28.76374666543395
112322,2068,11,4,15,M,28.944913719662733
169498,2067,5,1,6,Q,29.35564196045856
136809,2068,3,1,4,I,28.490685641790613
137739,2067,5,3,8,M,29.10246916843294
39402,2068,5,1,6,E,28.85579761439235
180950,2068,5,2,7,M,28.96318222579485
77547,2067,3,2,5,Q,29.406307856237127
125444,2068,4,0,4,E,29.04292477933319
21080,2068,3,0,3,E,29.181945700291458
131173,2068,4,0,4,M,28.70213476997028
30695,2067,0,3,3,E,29.32286440714374
22642,2067,5,2,7,E,29.26946519243074
20831,2068,7,2,9,P,29.224781621829067
148711,2068,2,2,4,P,28.77209292268549
176661,2068,4,4,8,D,28.53222697949439
96927,2067,5,1,6,Q,29.18703318646016
165406,2067,6,0,6,N,28.896384794832755
35780,2068,6,1,7,E,28.91194595507148
19625,2068,1,2,3,M,28.80432163624793
109839,2067,7,2,9,I,29.49419266783961
119066,2068,7,2,9,R,28.93144368546651
17516,2068,6,2,8,A,28.89213393078697
50252,2067,4,0,4,M,28.86397814031086
96843,2068,3,1,4,N,29.00885165684327
129899,2068,4,2,6,P,28.78525915502933
119486,2067,3,1,4,F,28.964803653612947
38538,2068,7,2,9,N,28.863151363343
98633,2068,4,0,4,E,28.75642693042583
160287,2067,2,2,4,E,29.054881764266856
137101,2068,5,2,7,P,28.9309421590088
137436,2068,2,3,5,J,29.17646513605781
95786,2067,3,1,4,A,29.28552828173227
63241,2068,9,3,12,M,28.71845970941241
30411,2067,5,1,6,I,29.48608945653033
74680,2068,6,2,8,J,28.861394845590432
25445,2067,9,2,11,J,28.84177573646479
60330,2068,0,4,4,D,28.679319474810875
93499,2067,4,1,5,N,29.383721413546297
167633,2068,7,0,7,Q,28.854660626584103
41835,2067,3,2,5,J,29.251174387534363
105105,2067,2,2,4,E,29.29870713814756
109548,2067,4,0,4,N,29.26747675952006
44586,2067,5,2,7,J,29.396732227595606
18351,2068,5,2,7,P,28.596918209129203
156219,2068,1,2,3,E,28.63325257786133
172143,2067,7,1,8,Q,29.262082214422172
47742,2068,4,0,4,K,28.26355670613588
73845,2068,5,0,5,Q,28.751397810382382
54176,2067,5,1,6,K,29.35898556227004
60137,2067,8,2,10,E,29.147686007264383
89268,2068,4,0,4,C,28.86571298067328
53056,2068,3,2,5,D,28.81844232255332
166117,2068,4,2,6,C,28.836554447549407
147840,2067,5,2,7,M,29.44326600280667
22348,2068,5,1,6,Q,28.62985837206522
105587,2067,6,2,8,M,29.23682612276257
171105,2068,5,0,5,N,28.86333104375281
42918,2068,7,1,8,J,28.96349405719195
70589,2067,8,0,8,H,29.02105084957176
174925,2067,3,0,3,N,29.12538792675921
171086,2067,3,2,5,J,29.23836745674754
40725,2068,6,1,7,Q,28.980543985995745
63387,2067,4,1,5,D,29.192572107674543
138794,2068,3,0,3,K,28.859592160953586
169466,2068,5,1,6,J,28.813759364800333
86295,2067,2,1,3,P,29.27916610536492
123672,2067,4,0,4,P,29.19015561692736
146294,2067,5,3,8,E,29.0692926771498
172611,2067,5,1,6,H,29.172554138740768
20054,2068,4,2,6,N,28.66598303758951
116203,2067,5,0,5,Q,28.98203682815476
40648,2068,5,3,8,J,28.686405152693272
129310,2068,3,2,5,K,28.57032799715624
93093,2068,6,2,8,E,29.216729954983737
95142,2067,4,1,5,N,28.92807153733118
147840,2068,5,3,8,M,28.77057413383106
172860,2067,6,2,8,D,29.068014958151185
111438,2068,6,2,8,J,28.61969813241405
115585,2067,5,3,8,Q,29.5744789272893
114511,2068,5,2,7,P,28.89560014720764
16593,2068,2,1,3,N,29.06225885121711
76889,2068,4,2,6,N,29.01053365066522
136922,2068,3,0,3,C,28.87645631385832
118576,2068,1,4,5,E,28.7376869583734
92874,2067,3,1,4,D,28.862505620208395
36701,2067,4,2,6,J,29.47073597832285
147466,2067,4,3,7,M,29.355594157618736
86347,2067,3,0,3,E,29.22094254233771
82131,2067,3,2,5,N,29.03219378126604
138838,2067,4,3,7,N,28.973432004840102
102833,2067,5,1,6,P,28.957637849353134
157708,2068,2,1,3,Q,28.80250940288516
135756,2068,2,2,4,M,29.097677295109158
44299,2067,5,0,5,A,29.23750936821405
36455,2068,3,1,4,N,28.866926830527756
105963,2067,5,0,5,J,29.30101155315828
36940,2067,2,2,4,K,29.443522459034007
96142,2067,5,2,7,Q,29.32321173198444
62884,2068,6,2,8,E,29.03924658385476
183452,2068,1,3,4,M,28.78849346305228
169258,2067,5,1,6,J,29.477593917380705
68980,2067,6,1,7,J,29.386993643523013
55690,2067,3,2,5,I,29.010528671138307
160125,2068,2,2,4,A,28.97302757440168
147877,2068,5,0,5,P,28.673641031961136
118562,2068,6,1,7,E,28.729828997109173
107269,2067,4,2,6,I,29.430515798191625
111435,2067,8,2,10,J,29.24266727525298
66675,2067,6,1,7,P,29.083355051195163
130362,2068,1,1,2,Q,28.891813884161014
89299,2068,7,3,10,C,28.515148587035323
85243,2068,13,1,14,D,29.056084957186616
133768,2068,6,0,6,E,28.885455011551105
83552,2068,4,1,5,E,28.98565548201059
135521,2067,5,4,9,P,29.398543352420724
167548,2068,4,1,5,P,29.011963148989174
150250,2068,4,0,4,M,28.58551557271941
136954,2068,4,0,4,M,28.80508434082829
94441,2067,2,0,2,Q,28.98356119188395
58894,2067,4,1,5,N,29.37529697999252
170302,2067,37,11,48,N,29.18914059513649
113612,2068,3,2,5,P,28.91560872365007
158740,2067,4,2,6,Q,29.364614920032547
148114,2067,3,2,5,P,29.05285738805786
99691,2068,5,2,7,E,28.97740957328848
60336,2067,6,2,8,D,29.35840105687553
17307,2068,4,0,4,D,28.96102585171604
55197,2067,3,1,4,E,29.33034227095729
135689,2067,5,1,6,N,29.19366270678396
138995,2068,4,2,6,M,28.997336277998347
158294,2067,3,1,4,P,29.023095421330456
71022,2068,4,0,4,M,29.02346585617845
117747,2068,3,4,7,E,28.952319391398717
129275,2067,2,3,5,P,29.12718407226682
112746,2068,2,3,5,J,28.908364880592423
144997,2068,10,2,12,M,29.041478507148764
55940,2067,3,1,4,S,28.86807349815089
21599,2068,5,2,7,N,28.326576607144048
170206,2068,9,2,11,D,28.980657510191328
113443,2067,21,5,26,E,29.00626465943053
36611,2068,8,0,8,D,28.451829920765736
134100,2067,4,2,6,M,29.060049479672923
61010,2067,3,0,3,Q,28.76460799431501
67541,2068,5,2,7,M,28.91389471797911
83109,2068,7,1,8,A,28.76208596468636
136816,2068,4,1,5,E,28.62104239778055
51622,2067,1,1,2,N,29.36835487339979
32012,2067,3,1,4,E,29.08064920161541
83019,2067,6,0,6,D,29.55591739319788
40598,2068,6,2,8,J,28.70868301015395
169792,2068,7,0,7,N,28.83157028714997
33905,2068,4,3,7,J,28.63619652637223
99970,2067,4,2,6,E,28.966783589261517
46633,2067,1,4,5,E,29.24687805131717
72791,2067,6,0,6,N,29.115181472000398
113107,2067,6,0,6,H,29.1987832338755
74321,2067,5,3,8,F,29.24144552531704
26990,2068,2,2,4,N,28.78001567721047
60597,2068,2,0,2,E,28.83377833494921
49688,2067,8,0,8,I,29.14255517226696
120507,2067,3,1,4,E,29.23051304369877
147012,2067,4,0,4,M,29.14285206144672
123648,2067,3,2,5,P,29.33690390996702
59824,2068,3,0,3,E,28.93270057514492
104723,2068,5,2,7,N,28.52246595280145
69623,2067,9,2,11,D,29.20304056777752
175776,2068,5,2,7,L,28.74360647789483
88888,2068,6,0,6,G,28.94001483495859
82373,2067,9,0,9,Q,29.08734806302625
117828,2068,7,2,9,M,28.76942922663071
90028,2068,5,1,6,J,28.87324934760187
99694,2067,3,3,6,M,29.142648475149823
34225,2067,5,2,7,M,29.0290892838936
148945,2067,4,1,5,M,29.16141252103436
41056,2067,2,0,2,N,29.12729061139941
60677,2068,5,0,5,N,28.66948582178188
175497,2067,6,0,6,J,29.18314336105396
161188,2068,4,0,4,N,28.87489654294438
146216,2068,7,1,8,P,29.077913742321225
32430,2067,5,3,8,E,29.521667215323024
81528,2068,1,3,4,J,28.649579277287792
144372,2068,4,2,6,N,28.82323162667159
21746,2068,5,2,7,E,29.014127902808443
138933,2067,6,2,8,M,29.343810056401573
107987,2067,4,0,4,Q,29.264626418209755
136446,2067,6,0,6,P,29.48061576182376
78969,2068,7,2,9,N,28.68761971831924
25592,2068,2,2,4,D,28.69739976691018
103650,2068,3,2,5,J,29.03208349595341
69757,2067,7,1,8,E,29.116473159810205
20445,2068,7,1,8,M,28.99205590419842
66035,2068,7,2,9,D,28.810138916829622
114613,2067,3,1,4,N,29.191275054796137
175921,2068,5,2,7,D,29.279602694919
18822,2068,9,0,9,E,28.93722981396329
69369,2068,5,2,7,E,28.727285460241216
180032,2068,8,2,10,Q,29.07921619876709
165446,2068,6,1,7,M,28.68090755643792
70342,2068,4,2,6,J,28.534002456140765
129234,2068,4,0,4,E,28.751002785746817
146889,2068,6,1,7,M,28.73717938907345
136337,2068,3,3,6,P,28.62899877674078
176243,2067,6,2,8,J,29.27148362050327
93415,2068,4,0,4,P,29.06797149918308
94852,2068,7,1,8,E,28.90234445469949
20355,2068,2,1,3,I,28.924629065758463
55345,2067,6,3,9,J,29.280125767363558
97793,2067,7,2,9,F,29.10439622733043
92344,2068,5,0,5,Q,28.920777623750173
145353,2067,4,0,4,M,29.055081184606028
175052,2067,5,3,8,J,29.01504839312961
97678,2067,5,0,5,P,29.3374684629711
133049,2068,3,1,4,K,28.88805542082905
93698,2068,5,0,5,N,29.14928445767906
172692,2068,9,2,11,D,28.839928989598818
174879,2068,4,1,5,F,28.999599453160243
172095,2067,4,2,6,E,29.286181373382504
161671,2068,4,1,5,S,29.30866182790768
181219,2067,4,0,4,N,29.31334763133624
171760,2067,7,0,7,Q,29.18923793438264
72459,2067,2,0,2,E,29.478035693603445
96078,2068,8,1,9,J,28.873758552125786
125728,2067,4,0,4,P,29.387302463380404
40698,2068,3,1,4,E,29.097047412084333
90776,2068,3,0,3,J,28.47775723710235
123684,2067,9,2,11,A,29.11637595300023
110379,2067,6,2,8,E,29.226202232002297
147533,2068,5,1,6,M,28.622645855916343
131570,2067,6,2,8,E,29.21986338998116
109434,2068,5,2,7,K,28.897579671865063
156147,2068,5,2,7,S,28.62793305508385
58989,2067,1,2,3,D,29.08457735568402
138642,2068,3,2,5,K,28.492605726440843
41624,2068,2,2,4,M,29.01983924119247
185010,2067,11,2,13,P,29.437382393188862
124234,2068,5,1,6,Q,29.110940453309727
23696,2068,15,2,17,D,28.537634302373245
140848,2067,4,0,4,Q,29.22844990640649
144078,2067,6,0,6,N,29.25098844101239
109272,2068,3,2,5,P,28.97131018677176
143680,2067,6,1,7,N,29.101928504787598
156320,2068,8,0,8,R,29.064285767971064
116914,2067,10,3,13,E,29.150970233510478
160690,2068,7,2,9,P,28.681768910408582
95970,2067,2,2,4,D,29.09946676919424
75703,2068,4,2,6,E,29.018031834231657
139382,2067,3,0,3,E,28.89804306942271
108397,2068,2,3,5,E,28.91268248370129
129788,2067,5,1,6,E,29.36665391464317
46298,2068,6,1,7,A,29.112539820918787
113370,2067,5,1,6,E,29.41503543032345
170210,2067,16,2,18,N,29.161557500855142
96349,2068,3,0,3,N,28.99008422297648
34364,2068,1,3,4,J,28.930142553828247
70466,2068,4,3,7,M,28.93156975529481
68861,2067,7,1,8,E,29.31297105882681
106119,2068,8,1,9,P,29.13764447219732
47292,2068,6,0,6,N,28.8182530897004
35527,2068,1,3,4,J,28.87411519913759
18816,2068,7,1,8,P,28.78332475040368
116334,2068,4,1,5,J,28.689798692368555
62854,2068,5,0,5,D,29.09948564153009
156469,2068,6,1,7,E,28.900218917973028
29978,2067,7,2,9,N,29.023559913047308
94022,2067,6,1,7,N,29.290158152801084
145347,2068,2,3,5,P,28.615539602178924
182369,2068,5,2,7,K,28.915824563954537
79575,2068,7,0,7,P,29.084626238276144
40627,2068,1,2,3,M,29.052942077518825
127142,2067,5,2,7,E,29.362727753939957
92259,2067,4,0,4,F,29.201558142571795
72633,2067,3,0,3,E,29.299724088034885
148532,2068,13,4,17,J,28.91907818357141
133676,2068,6,2,8,J,28.735259728367804
26234,2068,2,3,5,J,29.04347076160715
78682,2067,3,1,4,S,29.05533154679225
161767,2067,5,1,6,P,29.65459541568042
64996,2068,2,2,4,K,28.481557382209484
119327,2068,5,1,6,E,28.659737040191896
149441,2068,4,0,4,M,28.88332434194903
26909,2067,4,1,5,Q,29.20420572254032
149100,2068,4,1,5,P,29.0350235413676
132469,2068,7,0,7,P,28.704838566851897
102437,2067,3,1,4,D,29.21130951043657
38072,2068,10,2,12,Q,28.782367964537155
71405,2067,7,0,7,D,29.185927411338945
140020,2067,3,0,3,N,29.268033509452128
26185,2067,6,0,6,M,29.16805004006155
111467,2068,6,0,6,E,28.83419740530764
162168,2067,8,2,10,D,29.2245260973394
159499,2067,6,3,9,J,29.237119066495698
54501,2068,6,0,6,M,28.80289434275476
74684,2068,3,2,5,L,28.755461613570425
162647,2067,10,0,10,E,29.27945121387784
54494,2067,4,0,4,E,29.04891334733922
133538,2068,4,2,6,F,28.69484235081772
62343,2068,3,1,4,D,28.817770772112286
117465,2068,6,1,7,J,28.7224920697217
113980,2067,2,2,4,N,29.17914351102711
24334,2067,1,2,3,J,29.07069135054525
25488,2067,9,2,11,E,29.06619130310205
108176,2067,3,1,4,A,28.90148241076363
106492,2068,11,3,14,H,29.134268843633336
135689,2068,6,2,8,N,28.562207184378853
63762,2067,6,0,6,Q,29.05510024824626
180796,2067,9,3,12,E,28.92721254666321
173051,2068,4,0,4,H,29.010060427400106
112596,2067,3,1,4,E,29.06091750246131
85006,2068,4,2,6,K,28.720817775513357
85705,2067,6,3,9,E,29.138267987232872
56122,2068,9,1,10,P,28.973434050361902
22726,2068,2,2,4,M,28.902772668965685
52302,2067,6,3,9,K,29.19125465937397
87024,2067,4,1,5,P,29.202078016710267
141036,2068,4,2,6,N,28.498079093792427
94674,2068,2,2,4,Q,29.097371284480094
104385,2067,6,1,7,K,29.487861383510342
77772,2068,6,2,8,F,28.85419492706848
173828,2067,6,0,6,D,29.108230636719156
90020,2068,4,2,6,H,28.9058620555934
47764,2067,1,2,3,N,29.486547538474696
44736,2068,4,3,7,K,28.716905980374765
163093,2067,5,0,5,J,28.673691396154997
71824,2067,5,2,7,E,29.39912032848039
24864,2068,4,2,6,D,28.622763632675024
16710,2067,6,2,8,D,29.060320350573186
142070,2068,3,2,5,E,28.80101915483313
91828,2067,2,1,3,N,29.05668070963368
131122,2067,4,1,5,N,29.49702765121467
146890,2067,2,3,5,P,29.56087550119341
106898,2068,4,2,6,L,28.93276552803944
113797,2068,1,3,4,E,28.59819291610884
41626,2068,7,2,9,E,28.736795862784323
21232,2068,6,0,6,P,28.81267134504401
63809,2067,5,1,6,M,28.948935181390773
150761,2068,7,0,7,M,28.777786332859986
147481,2068,4,2,6,A,29.039069965004025
162811,2067,5,2,7,Q,29.080755879494102
90672,2068,3,1,4,E,28.706833624786373
145665,2068,6,0,6,K,28.73993029900885
164116,2068,5,0,5,E,29.099843679759868
54911,2068,7,2,9,N,28.793129065177663
160522,2068,4,2,6,E,28.89073731308292
65575,2067,6,2,8,D,29.12578942001374
157369,2067,9,0,9,P,29.209386138684547
119125,2067,11,3,14,E,29.035586757544745
129516,2067,3,3,6,M,29.16718095937226
96695,2067,3,2,5,R,28.796565974933586
144372,2067,4,2,6,N,29.03182537592628
160796,2068,2,1,3,K,28.86695858943861
61012,2067,3,4,7,N,29.031637372973904
177424,2068,7,1,8,E,28.828938342109332
64836,2067,6,0,6,N,28.97123601473665
64259,2067,9,1,10,A,29.15112852212174
128005,2067,6,2,8,P,29.00488905196521
145815,2068,4,2,6,E,29.04460433241959
102401,2068,5,3,8,E,28.89031625403793
40945,2067,4,1,5,J,29.146429457899423
60902,2067,4,2,6,D,29.366061137711977
158709,2068,4,3,7,E,28.65123217898332
159178,2068,4,3,7,I,28.82794455645257
122493,2068,3,2,5,J,29.11883979763951
156295,2068,6,2,8,N,28.58200225155853
56328,2067,5,1,6,N,28.9823115556443
98630,2068,7,0,7,E,28.835071640363896
124369,2067,2,2,4,D,29.25717636728764
136218,2068,5,3,8,P,28.888916551403995
117112,2068,3,2,5,I,28.840880428124294
147361,2067,5,1,6,K,29.35044795628422
142629,2068,4,2,6,K,28.64465261095957
158926,2067,3,1,4,E,29.11597020601455
121710,2068,5,2,7,P,28.775853102202323
99721,2068,5,3,8,J,28.88852620183016
70741,2067,4,2,6,M,29.367527782282547
92177,2067,5,1,6,Q,28.988453382970587
64789,2068,5,2,7,E,29.18191494100064
96417,2068,10,5,15,N,28.984260604673334
101561,2068,3,1,4,E,28.730547337847145
176181,2067,5,0,5,N,28.77685224153665
144582,2068,4,0,4,J,29.08363995547401
90440,2067,6,1,7,M,29.300006670295925
127226,2067,5,2,7,J,29.11469038640924
19891,2067,6,0,6,C,29.356601462171625
121831,2068,2,3,5,M,28.9457720984844
64260,2068,5,2,7,E,28.990406302746035
107981,2067,5,0,5,S,29.22512452526299
93939,2067,4,2,6,N,29.169158691284878
67479,2068,4,2,6,E,29.06149093564813
170090,2068,3,2,5,N,28.879325377696738
130960,2068,2,3,5,P,28.77000713472977
98890,2068,5,3,8,N,29.05675842660585
103837,2067,2,2,4,P,29.245868831062324
111525,2067,6,2,8,J,29.33647358401799
124065,2067,1,5,6,M,28.8837722637628
100381,2067,3,2,5,N,29.2289156095379
53719,2067,2,0,2,K,29.02396071125824
84472,2068,5,2,7,D,28.85757308243293
67861,2068,5,7,12,P,29.12363758746782
128632,2067,3,2,5,E,29.13535373480825
55434,2067,5,2,7,P,29.14747267881659
21660,2068,5,2,7,N,28.82664723965865
142405,2067,5,0,5,E,29.323645663435663
139973,2068,6,0,6,S,29.061765629863164
108105,2067,4,1,5,K,29.184084709293227
109281,2068,3,1,4,N,28.97492551937788
69263,2067,4,2,6,K,29.404233475935072
140356,2067,6,2,8,N,29.301360805888027
135164,2067,2,2,4,E,28.96570267263367
110000,2067,4,2,6,E,29.05362417720359
32463,2067,6,2,8,P,29.33516296449652
19276,2068,8,2,10,J,28.82831462850852
85296,2068,2,2,4,E,28.784154159550997
96421,2068,4,3,7,J,28.71057116298285
76136,2068,3,2,5,K,28.712901700100296
25516,2068,5,0,5,N,28.86683667181807
46001,2067,3,2,5,J,29.30506339129897
180546,2067,4,2,6,Q,28.98450034696225
179437,2067,7,1,8,N,28.926345499902585
169318,2068,4,1,5,D,28.939662987411698
139840,2067,6,2,8,K,29.28916089338408
137770,2067,4,0,4,P,28.853339352936818
64049,2067,0,2,2,G,28.96724216994805
47090,2068,5,0,5,N,28.72378561384905
57060,2067,3,2,5,M,29.194203416360256
177059,2068,6,2,8,E,28.89241423691866
101701,2067,2,0,2,Q,29.148237742349806
90078,2067,1,3,4,D,29.20278750000218
158091,2067,5,1,6,E,29.410457792107536
123693,2068,6,0,6,D,28.854024536834466
26834,2068,2,1,3,E,28.955367643841956
100498,2068,6,2,8,P,29.02389815414145
72220,2068,3,2,5,M,29.17682023294871
64988,2067,2,1,3,E,29.11629485253121
145771,2067,5,1,6,E,29.30313647511821
140665,2068,6,2,8,E,29.175797351365723
38874,2068,5,0,5,K,28.81280027513868
107707,2067,1,4,5,E,29.200688468373222
180699,2068,3,1,4,N,28.603817070566038
108215,2067,5,1,6,E,29.04953892261467
29539,2067,7,2,9,E,29.34809070962567
100612,2068,4,2,6,N,28.875944308090784
25610,2067,3,2,5,N,29.220099427429822
140861,2067,6,1,7,M,28.930473583614823
61868,2067,6,0,6,N,29.02166695335213
26312,2068,5,0,5,Q,28.857446091089475
96986,2068,4,4,8,N,28.79418908643714
127760,2067,6,2,8,F,29.127350117909725
102926,2068,5,2,7,Q,28.67650403597068
92365,2067,7,1,8,C,29.171553600497724
185007,2067,14,3,17,P,29.242908641652694
93576,2068,2,0,2,K,28.790681032466527
163232,2067,6,2,8,N,29.2563599520666
28573,2067,2,1,3,N,29.33135725547205
106889,2068,4,1,5,N,28.3614257000213
156906,2067,10,4,14,D,29.19711669296372
120518,2067,6,0,6,E,29.31282419438233
167018,2068,2,3,5,N,28.762748194571305
113233,2068,6,1,7,E,28.851957827805013
81860,2067,16,4,20,H,29.23499251424142
75835,2067,6,2,8,K,29.23718427537032
160831,2068,1,1,2,N,28.84771081655942
158189,2068,6,0,6,N,28.871132302480294
174780,2067,4,2,6,K,29.29191415824531
48839,2068,3,1,4,E,29.015028213725124
59340,2067,3,2,5,N,29.25107649979598
98355,2068,3,1,4,M,28.60770212377514
33199,2068,10,1,11,E,28.726152086331695
99232,2067,6,1,7,E,28.946930146045982
165259,2067,5,2,7,M,29.01040112595797
146000,2068,5,3,8,Q,28.7487150570214
64254,2067,6,0,6,N,29.45831448714883
50798,2067,6,3,9,A,29.222683488532592
151176,2068,7,0,7,M,28.74986678913764
158030,2067,7,2,9,E,29.07292291728568
142070,2067,6,2,8,E,29.03066776929922
45900,2067,5,2,7,N,28.96716612315573
93041,2068,4,1,5,E,29.146656241209683
37716,2067,2,1,3,E,29.27690877819273
26363,2068,4,3,7,Q,28.833768012913165
160737,2068,5,1,6,N,28.82602785505047
78713,2068,7,2,9,M,28.67736444798301
79398,2068,6,0,6,Q,28.741649865406348
143707,2067,9,7,16,I,28.985878010130445
108478,2067,2,0,2,N,29.339578025545364
59632,2068,6,0,6,J,28.94525442865921
46533,2068,11,0,11,A,28.81434147941535
121104,2067,5,0,5,S,29.321011459848783
134202,2067,7,2,9,N,28.961686619138614
19941,2068,3,2,5,E,29.04373889164593
68038,2067,5,1,6,F,29.057450481740634
92132,2068,8,0,8,M,28.463819780198985
142104,2067,3,0,3,E,28.968009499090307
113850,2068,5,2,7,J,28.916971004441443
50437,2067,3,0,3,E,29.145744157761957
124198,2067,4,1,5,P,29.205004153352263
113849,2068,8,2,10,P,28.891374839134134
120653,2068,3,2,5,J,28.823918878164186
119644,2068,4,0,4,K,28.74154026277218
100352,2068,4,0,4,N,28.998594294803205
83019,2068,4,2,6,D,29.05423666148254
56246,2067,5,1,6,N,29.362385907564292
156760,2067,3,2,5,N,28.95752181882332
71338,2068,6,2,8,E,28.763911498579365
120360,2067,4,3,7,K,29.216743572965747
157754,2067,6,1,7,M,29.237543363629666
85911,2067,5,4,9,M,29.37469516771976
135626,2068,3,2,5,E,28.799525018310216
55341,2067,4,1,5,P,29.09696399707249
137516,2068,8,0,8,P,28.990821366048007
100497,2068,4,0,4,Q,28.78655405098768
156065,2068,3,1,4,N,28.810615840037823
76420,2067,6,0,6,M,29.332030315195468
180174,2068,5,2,7,N,28.764389290127617
115591,2068,4,2,6,D,29.031565566965863
68913,2068,6,2,8,N,29.194948288782808
103213,2068,2,2,4,N,28.90300935128192
72386,2068,3,2,5,E,28.937862337759075
161083,2068,3,0,3,L,28.74579308567127
27097,2068,6,2,8,E,28.791444205265528
113233,2067,5,0,5,E,29.23368072204825
30288,2068,3,2,5,E,28.6556752096496
98030,2067,10,2,12,M,28.821468525406654
107265,2068,4,2,6,E,29.083707138414884
174442,2067,6,2,8,N,29.050853829220053
131155,2067,5,4,9,P,29.115770867716986
17079,2067,3,1,4,E,29.360302837621244
36870,2068,5,3,8,I,28.692022912870637
128564,2068,9,2,11,E,28.966660483945045
45429,2067,2,2,4,D,29.01205842186366
76968,2068,5,2,7,N,29.005095011695374
90113,2068,6,1,7,M,28.726947742653483
119839,2067,15,5,20,E,29.262849195662973
59656,2067,13,1,14,D,29.06343152531285
30893,2068,2,2,4,Q,28.86692136910549
100991,2068,10,1,11,E,28.607113616971265
147867,2068,7,1,8,M,28.661509608729457
124821,2067,5,0,5,J,29.584201178372098
172886,2067,4,2,6,M,29.10917994804926
157720,2068,2,1,3,N,28.81696585004975
146432,2067,6,0,6,E,29.14672486463068
116265,2068,2,1,3,J,28.71468750190797
84248,2068,5,1,6,N,29.10566767994994
113825,2067,5,2,7,P,29.21915568406522
145926,2068,3,2,5,M,28.748461003093396
92003,2067,2,2,4,A,29.35913923010893
62736,2067,2,1,3,J,28.89318852125676
51232,2068,4,2,6,F,28.87840903185616
100375,2067,4,1,5,I,29.315539488193327
82942,2068,6,2,8,E,28.70840252627437
21231,2068,5,0,5,N,28.698153690188324
103927,2067,3,2,5,E,29.017012740491264
75244,2068,5,3,8,E,28.85592809658703
41064,2068,6,0,6,S,28.697513901762125
88283,2067,9,3,12,M,29.265888610535367
95430,2067,5,2,7,J,29.169588258935303
135014,2067,5,1,6,N,29.28127087455497
32223,2067,17,1,18,E,29.32349282012368
39159,2068,3,2,5,E,28.77044857181252
28527,2068,4,3,7,J,28.791364880923567
54151,2068,5,3,8,N,29.01307636399008
121962,2068,4,2,6,N,28.898587605130256
44738,2067,8,5,13,I,29.14394005167204
99403,2068,4,2,6,E,28.729157825966364
99969,2067,6,2,8,Q,29.17709922091339
109257,2068,13,2,15,N,28.819268565535047
156819,2067,5,2,7,E,29.047719043347687
117960,2067,3,1,4,E,29.402123360179782
29948,2067,4,3,7,D,28.91415222505588
89766,2068,1,3,4,S,28.722117463579806
49484,2068,3,2,5,N,28.80117328602932
22552,2068,3,1,4,M,29.098189427929203
38504,2067,5,1,6,P,29.27951334920223
99309,2068,4,3,7,Q,29.16219470165345
28694,2067,3,0,3,D,29.05837857110497
135100,2068,5,0,5,P,28.74619244645421
107607,2068,9,3,12,I,28.66737737901809
66420,2067,9,1,10,E,29.111498114666123
71754,2067,4,0,4,N,28.991732795246943
65559,2067,6,1,7,E,29.22420131182523
31861,2068,2,2,4,E,28.986408785464096
22184,2068,6,1,7,N,28.865943300040666
148765,2068,7,2,9,M,28.78918593105595
107409,2067,4,2,6,I,29.31365068616565
78824,2067,6,2,8,M,29.235914898807767
78471,2068,7,0,7,Q,28.46883432024404
179545,2067,5,1,6,Q,29.0881093172998
27380,2067,6,1,7,E,29.23288189328078
44783,2068,2,0,2,J,29.038436387700163
90494,2068,4,2,6,I,29.07135155991993
124327,2067,4,0,4,K,29.349805370699126
177544,2067,6,0,6,P,29.19741588593706
36740,2067,4,1,5,P,29.45668920671388
77407,2068,7,2,9,K,28.84612740241871
36923,2068,3,2,5,N,29.22415306861502
117011,2067,11,3,14,K,29.261372217404208
85983,2067,5,1,6,D,29.278400574401804
49299,2067,1,2,3,S,29.07216274068629
29962,2067,5,0,5,K,29.15902817901096
147175,2067,3,4,7,M,29.281353061112476
164668,2067,6,1,7,I,29.08405980083741
100091,2068,2,4,6,N,28.912889474001265
69970,2068,5,2,7,E,28.989128539111363
89691,2068,7,2,9,D,28.67271870782365
36923,2067,4,1,5,N,29.2479370208549
48846,2067,6,4,10,J,29.37551653650789
130452,2067,7,2,9,M,29.420296892359232
64110,2067,6,1,7,Q,29.115617948570836
53988,2068,5,2,7,Q,28.80907699259496
67368,2067,2,2,4,N,28.933294849418065
129022,2068,6,1,7,M,28.66392229774301
141877,2067,7,0,7,Q,29.26895080208886
70681,2068,2,2,4,Q,29.084646769165875
139141,2068,6,0,6,M,28.93442871352639
41347,2068,7,1,8,S,28.837638801689863
59378,2067,8,1,9,N,29.04930155730848
144767,2068,7,2,9,M,28.858788990209234
110413,2067,6,2,8,E,29.19096442502015
82091,2067,5,2,7,D,29.42814049577441
182822,2068,6,1,7,M,28.674450016081543
64427,2067,2,2,4,J,29.290006176193167
136862,2068,8,4,12,P,29.161447012656623
112224,2067,6,0,6,K,29.032627130784103
106617,2067,6,0,6,E,29.32594895533128
127962,2068,5,3,8,M,28.74144922038708
178503,2067,6,0,6,E,29.35687144087422
29766,2067,4,3,7,J,28.94248475292624
135305,2068,7,1,8,K,29.065088496769413
147127,2068,2,3,5,M,29.20683842868429
19739,2068,2,0,2,J,28.46521125699754
166447,2067,4,1,5,M,29.18445104914225
158796,2068,3,1,4,S,28.719132245669
112435,2068,7,2,9,E,28.956325305044626
157056,2067,3,3,6,N,29.138816456731423
180905,2067,5,2,7,D,29.365855087131514
15784,2068,2,3,5,A,29.115360537074167
148335,2067,4,2,6,M,29.21347369720849
90330,2068,7,2,9,M,28.783161856164234
48415,2067,2,1,3,D,29.009319630877524
106569,2067,6,1,7,J,29.084285088983133
156133,2068,5,2,7,N,29.197753554755337
22165,2068,5,0,5,N,28.27158226866504
157102,2068,4,0,4,P,28.812578913553523
64107,2068,3,1,4,P,28.743638988463307
60731,2067,6,1,7,N,28.87007915389431
127413,2067,6,2,8,K,29.272319884929253
90790,2068,3,1,4,Q,29.22390129858352
146910,2067,4,1,5,M,29.01956652451946
37330,2068,6,2,8,M,29.51411875150031
148034,2068,3,2,5,M,28.8304685727746
132691,2068,2,0,2,P,28.79667241134888
44460,2068,13,0,13,A,28.91854282366895
143822,2067,4,0,4,S,29.429047380148177
111416,2068,6,1,7,M,28.65046409048215
157183,2068,2,1,3,J,28.833849723509765
56505,2067,6,0,6,D,29.26054041316832
48934,2067,4,0,4,N,29.341918171882053
137931,2068,4,1,5,M,28.712745283559187
105936,2068,1,4,5,N,28.86089701332917
78671,2067,6,2,8,N,29.151523173288105
174171,2067,3,3,6,J,29.09682557580472
176512,2068,2,1,3,A,28.814633818965817
18005,2067,6,2,8,P,29.522835336886327
45559,2067,5,2,7,E,29.303707635124844
145054,2067,7,1,8,D,29.182106763912465
118527,2068,6,0,6,P,28.837689161508543
78546,2068,6,1,7,E,28.741272546106952
24845,2067,5,2,7,J,29.28229491511731
58638,2067,5,2,7,D,29.007009075092896
119705,2067,5,0,5,S,29.15796927952387
147203,2067,7,1,8,M,29.39526612148444
174672,2067,3,2,5,P,29.150611426873425
38542,2067,3,2,5,E,29.086642569872964
160925,2068,6,2,8,N,28.89614725229728
66204,2068,5,2,7,E,28.77256583181151
81375,2068,11,2,13,D,28.83680830609333
133935,2067,6,3,9,K,29.253280183537367
84175,2067,5,3,8,E,29.23376904549349
176779,2068,3,2,5,I,29.03170197793309
69738,2068,4,2,6,P,28.598981992551032
115138,2067,5,0,5,I,29.084809207791743
148714,2068,3,0,3,Q,28.758389203480025
142141,2067,3,3,6,J,28.86943765252305
178181,2067,3,2,5,D,29.20466908068407
161776,2067,5,0,5,D,29.122484515210573
81242,2067,3,2,5,P,29.049242876554448
19144,2067,6,4,10,M,29.05201382447375
167269,2067,4,2,6,L,29.305695732152564
18541,2068,3,5,8,E,28.74332349255429
130078,2068,21,4,25,E,28.471819707414657
129693,2067,3,2,5,N,29.17838099550467
21204,2068,3,3,6,N,29.09960076629362
66750,2067,6,3,9,Q,29.37498591602208
59741,2068,3,1,4,E,29.20883883925494
105607,2067,6,0,6,J,28.98351068015297
97262,2067,3,2,5,P,29.188753372181417
44524,2068,6,2,8,E,28.62224292545788
128082,2067,5,3,8,E,29.01882358431064
166564,2067,5,2,7,N,29.21651738211246
171389,2068,2,2,4,N,28.780318320743604
171853,2068,2,2,4,D,28.87224243383482
96540,2068,7,0,7,K,28.992438431236547
132708,2068,3,1,4,M,28.97234993977635
27470,2067,2,0,2,E,28.92567449244613
122516,2068,6,0,6,E,28.9891329199023
144446,2068,6,0,6,P,28.934267403422005
57349,2068,4,2,6,P,28.979183569855337
138249,2067,2,3,5,A,29.1207358131688
56965,2067,6,0,6,M,29.44852670884496
40170,2068,5,0,5,Q,28.665434144718414
27295,2068,9,0,9,K,28.963848585148053
96942,2067,2,2,4,E,29.013724956834334
36350,2067,5,2,7,H,29.161456661045342
143399,2068,21,2,23,P,28.825076821181337
26486,2068,3,2,5,P,29.097818444247075
129010,2068,3,2,5,P,28.64178607961181
144283,2067,8,0,8,N,29.16748297104269
181097,2068,5,2,7,D,29.082869772127896
96347,2068,6,2,8,N,28.67633932799148
107878,2068,3,2,5,J,28.62235270216017
164138,2067,5,1,6,P,29.436899943032238
83232,2067,4,2,6,E,29.29087335861269
107037,2067,1,1,2,E,29.280880694507687
137946,2068,4,0,4,Q,28.72791202874796
99853,2068,14,4,18,R,28.74376730212601
138773,2068,3,1,4,K,28.82492246121505
110924,2068,5,1,6,N,28.655849039630453
181270,2068,6,2,8,M,28.96334085868961
16757,2067,8,1,9,A,29.12558559805101
140247,2067,4,2,6,N,29.24465451563008
27625,2068,4,2,6,P,28.90910650211686
110362,2067,9,3,12,E,29.236757430021598
70539,2068,4,2,6,E,28.767017381492156
60550,2068,4,2,6,Q,28.996887859688176
33749,2068,10,2,12,S,28.937579970950686
51543,2068,8,0,8,E,28.757033163831885
97480,2067,5,1,6,M,29.40708997988101
157737,2068,4,1,5,J,28.984815867051772
179898,2067,3,0,3,N,29.26640261959969
121222,2068,5,0,5,E,28.836640259493706
17536,2067,4,0,4,P,29.141157277001323
128003,2068,4,0,4,D,28.677794704444317
36352,2068,2,1,3,P,28.76526370583648
135230,2068,8,0,8,N,28.356126138118174
86554,2067,6,0,6,E,29.168895412111635
85313,2067,4,0,4,D,29.19065244443065
61373,2067,4,2,6,N,29.272511920513143
97563,2068,12,4,16,A,28.88318406289161
94022,2068,8,0,8,N,29.055294237996872
51367,2068,4,3,7,N,29.03012901806784
106820,2068,3,3,6,E,28.806139629879148
165453,2067,5,0,5,P,29.132201004469195
119434,2068,5,0,5,E,28.92010475431212
27869,2068,7,0,7,D,28.38812822595735
54831,2067,4,1,5,M,29.24134762791352
56357,2067,3,2,5,J,29.02025079620949
65726,2068,1,1,2,P,28.86109759774343
107809,2067,4,0,4,N,29.34648137836718
29236,2068,6,4,10,D,29.16832021001471
63737,2068,3,1,4,N,28.558892221878622
18840,2067,3,0,3,K,29.382312669732396
62136,2068,9,4,13,R,28.89131455883744
130096,2068,4,1,5,P,29.15151771640553
20082,2068,2,2,4,E,28.606029916802843
54519,2067,4,2,6,J,29.0455379124729
28951,2067,3,2,5,E,28.92505891252333
90529,2067,5,0,5,M,29.09062517315044
29282,2067,4,2,6,E,29.024264013293084
89361,2068,4,0,4,D,29.145118235071106
161218,2067,3,1,4,M,29.333528086666583
103065,2067,5,3,8,Q,29.314646451928763
142900,2068,3,1,4,N,29.02051653460252
72461,2067,6,2,8,N,29.06757632231759
26988,2067,3,1,4,P,29.698227841334848
15760,2068,6,0,6,P,28.928516594268896
19650,2068,3,3,6,E,29.02398903016639
108291,2068,4,1,5,J,28.735528929444907
181112,2068,6,2,8,H,28.8691466183565
129539,2068,6,2,8,N,28.528187465653748
77953,2067,3,0,3,M,29.20814481801444
60042,2067,1,1,2,D,29.32253070109668
100375,2068,3,2,5,I,28.811793114810747
161759,2068,7,0,7,A,28.8884729433247
180922,2068,3,0,3,Q,28.9200002010818
71609,2067,4,2,6,J,29.42901940900582
175189,2068,2,1,3,P,28.829089088139323
94158,2068,2,0,2,N,28.76029684312533
76233,2067,8,1,9,P,29.003651939780244
15752,2068,6,1,7,E,28.63785253738824
78250,2068,4,4,8,M,28.77214238098339
25625,2068,3,1,4,D,28.89479391382611
175681,2068,3,2,5,D,28.90806777310861
75787,2067,4,0,4,Q,29.3054551709814
182962,2068,3,1,4,K,28.905141762712116
139606,2068,3,0,3,M,29.181482771365133
171938,2067,4,0,4,E,29.48742338013762
119189,2068,4,2,6,N,29.12525530940476
132352,2068,5,1,6,S,28.87827043313641
19046,2068,5,2,7,D,29.060440655500315
149551,2068,4,4,8,M,29.119824004472385
109483,2067,3,4,7,E,29.36615034598671
130956,2067,5,2,7,C,29.20981344254748
142539,2067,4,2,6,N,29.131694469449176
130610,2068,6,0,6,P,28.78596092584189
45847,2067,3,1,4,J,29.0233245858238
40499,2068,5,3,8,I,29.081410836789026
125206,2067,1,3,4,N,29.00615416209622
45491,2067,2,1,3,J,29.05391989476087
76111,2067,3,0,3,J,28.90203798836695
113096,2068,1,3,4,J,28.463428088581857
118200,2067,2,0,2,D,29.46286726520306
135086,2067,0,4,4,M,29.06674820671154
83549,2067,7,2,9,Q,29.42078910740166
125133,2067,3,1,4,M,29.08241863892747
94968,2067,5,0,5,E,29.07253544286333
132584,2067,3,1,4,K,29.326693102692445
110459,2067,4,2,6,S,29.036120338242576
147214,2067,3,1,4,N,28.920611661786754
120193,2067,7,0,7,E,29.198440530613556
17820,2067,3,1,4,J,29.21825483158533
123212,2068,2,2,4,M,29.08910563903814
146994,2068,4,1,5,E,29.225560716157386
26812,2068,1,2,3,N,28.926239608398408
16635,2067,6,1,7,D,29.031846775950672
76042,2068,3,2,5,N,28.55992473178252
64230,2068,2,1,3,E,28.707903240644228
95267,2067,3,2,5,D,29.453919584050062
174854,2067,5,2,7,J,29.15972425562029
38063,2067,5,2,7,N,28.910235440818063
92670,2068,12,4,16,E,28.84180201972412
19513,2067,3,2,5,N,29.125622063974
179971,2068,6,1,7,G,28.886256439172392
20349,2068,3,2,5,Q,28.63965681391854
37461,2067,7,1,8,H,29.209362762659
138214,2067,4,1,5,E,29.262792374033992
145036,2068,4,2,6,J,28.607538621473296
118167,2068,6,1,7,N,28.826190689899686
129465,2067,6,2,8,K,29.01513114069845
55270,2068,2,1,3,S,28.874477934870388
16969,2067,4,1,5,N,28.98408427709051
134363,2068,4,1,5,D,29.107827361792136
45488,2067,6,1,7,M,28.77235996724164
137029,2068,7,2,9,Q,28.50069341087219
94008,2067,5,1,6,E,29.031195831224963
182244,2067,3,1,4,J,29.3136183967392
157239,2068,21,6,27,H,29.077868712978567
69886,2068,8,5,13,I,28.82238872241859
62566,2068,5,0,5,E,28.603655758365893
159414,2067,8,0,8,N,29.034797077826692
132461,2067,2,3,5,N,29.227581006282392
129688,2068,6,0,6,A,29.142745087242528
103169,2068,6,0,6,J,28.73307341625021
141311,2068,4,1,5,M,28.905809179947557
32231,2067,1,2,3,E,28.80280229332854
169739,2068,4,2,6,D,28.632469392317574
51468,2067,3,0,3,N,29.131524527423736
34230,2067,3,2,5,P,29.535816426154582
22701,2067,6,0,6,M,28.9652688310398
47992,2068,2,2,4,Q,28.567103214394063
75972,2067,1,2,3,M,29.278608070063367
103206,2068,4,1,5,E,28.771633799564967
108309,2068,5,2,7,M,28.80079855874695
120004,2068,37,3,40,E,29.0305894216292
139674,2068,6,2,8,Q,28.795764041689274
74749,2067,1,1,2,D,29.029245415223087
71515,2068,7,3,10,E,28.83376160212624
174041,2067,5,1,6,D,29.577108523094804
148189,2067,7,0,7,K,29.355496830812196
86752,2067,4,2,6,P,29.042491713782
17314,2068,5,1,6,P,28.924692269187645
60586,2068,3,1,4,D,29.01812329603036
84250,2067,6,0,6,Q,29.180689661651154
67777,2068,3,0,3,E,28.90161564770435
112002,2068,3,2,5,J,29.006542631668815
76985,2068,8,0,8,Q,29.1901228088286
31079,2067,5,1,6,E,29.464832328814488
140339,2068,5,2,7,M,28.86801220032965
51814,2067,5,1,6,K,29.044453790036957
148257,2068,5,1,6,E,28.76738781009765
57011,2068,6,0,6,H,28.70093677854698
84810,2067,5,0,5,R,29.200399881331293
28730,2068,3,0,3,E,28.884796141335396
89674,2068,3,0,3,F,29.003010476019096
136729,2068,4,2,6,Q,28.937481071102265
175282,2068,5,2,7,D,28.555900186826577
170757,2067,4,1,5,Q,29.03738565644016
146909,2068,4,2,6,F,28.7165513588006
51182,2067,4,0,4,R,29.76729871246613
39762,2068,4,1,5,D,29.11600887116978
96354,2068,3,1,4,N,28.64113504645028
89717,2068,3,3,6,S,28.52253275008588
69614,2068,5,2,7,P,28.97328387366371
81705,2068,6,0,6,N,28.77328208109044
39413,2068,6,2,8,Q,29.10605967777242
37393,2067,4,1,5,Q,29.154776443302485
160509,2067,2,1,3,J,29.233967716345145
112066,2067,4,1,5,M,28.953562330153154
167479,2068,3,2,5,C,28.901051416845178
74432,2068,7,0,7,M,28.837832454961905
78514,2068,4,2,6,D,29.075536058493228
55627,2068,4,0,4,E,28.760540406556373
104496,2067,9,2,11,Q,29.35194829451131
177040,2068,1,2,3,F,29.26852608495165
69771,2068,4,2,6,N,28.82374509505912
103058,2067,3,2,5,Q,29.458527695578866
38519,2068,5,2,7,E,28.819412913179303
118583,2067,6,0,6,Q,29.388786811880387
122468,2068,6,2,8,E,28.91651618618145
136000,2068,3,0,3,Q,28.95721922689249
125361,2067,8,0,8,E,29.2445139110012
183432,2068,2,3,5,M,28.616177276235245
109922,2067,3,2,5,P,29.38822076888248
144676,2067,4,0,4,F,29.319879216939736
95469,2068,4,0,4,M,28.63848237140733
87335,2068,5,2,7,K,29.13572896256144
51798,2068,6,2,8,J,29.18897985042482
111759,2068,8,1,9,A,28.86149422759953
44410,2068,10,1,11,A,29.096204128544127
88252,2067,2,3,5,H,29.18704936246056
85231,2067,2,1,3,D,29.253284620176004
179617,2067,5,1,6,E,29.027114656879835
94591,2068,2,1,3,P,28.73413056227137
147050,2068,6,3,9,M,29.34503830447821
173175,2067,24,3,27,C,29.437089802524778
144051,2068,5,2,7,N,28.65639532394372
32647,2067,4,2,6,J,29.20382791803384
42620,2068,2,2,4,D,28.82105003275285
60270,2068,2,1,3,J,28.81376460224417
147721,2067,6,3,9,N,29.473499719736825
143693,2067,3,2,5,M,28.85167785294958
77403,2068,8,2,10,J,28.98850470471949
140248,2068,3,2,5,P,29.024115664742787
163503,2068,4,2,6,M,29.17312771829849
71809,2068,5,2,7,E,28.850422166351613
55585,2068,7,1,8,M,29.096108162078767
47580,2068,3,3,6,J,28.81053183524733
30126,2067,4,1,5,K,29.227747641772883
111510,2068,8,0,8,P,28.86023721376438
60538,2068,5,3,8,M,28.688107523587025
115373,2068,4,0,4,E,28.763921425452544
137925,2067,5,2,7,M,29.234358767911694
145903,2067,4,2,6,M,29.46357495391577
142925,2067,5,2,7,M,29.100554918236305
174220,2068,12,2,14,M,28.679618258985894
26034,2067,4,0,4,E,29.402672057760384
132689,2068,5,2,7,P,29.200544739270367
121809,2068,7,0,7,N,28.79647499573187
178725,2067,6,0,6,J,29.26015547104412
122778,2068,5,0,5,D,29.122954792170155
51607,2068,2,2,4,M,28.881214587453965
102323,2067,7,3,10,Q,29.12410058686431
16891,2067,2,0,2,D,29.24872694458395
113149,2067,4,1,5,E,28.931284038182334
20057,2068,2,2,4,E,28.780437283256244
138755,2067,1,3,4,N,29.22771076693053
112217,2068,4,2,6,J,28.520325625500643
29006,2067,3,1,4,E,28.99252493668858
65430,2067,5,0,5,E,29.1017117192776
131696,2068,2,1,3,M,28.77559674743995
100172,2067,2,3,5,E,29.42685709340066
45710,2067,4,1,5,D,28.910771440245384
134196,2067,3,5,8,N,29.10311844804212
178580,2068,6,0,6,P,28.695231825988923
67437,2068,5,0,5,P,28.76602041710631
37941,2068,4,1,5,P,28.950208758735855
111753,2067,3,0,3,J,29.032834427829435
110678,2067,11,0,11,P,29.361120563947992
60677,2067,5,0,5,N,29.03927372517894
21321,2067,5,2,7,K,29.014061876554617
173434,2067,6,0,6,A,29.456659564883783
63672,2068,3,2,5,M,28.591897388237147
165863,2067,5,2,7,M,29.05135810254088
161960,2068,5,1,6,M,28.870158780977583
36383,2067,5,0,5,Q,29.321671842230696
106884,2068,5,2,7,A,28.812797034456047
33689,2068,3,2,5,E,28.72800260928296
42445,2068,2,4,6,F,28.7920749382399
132752,2067,2,2,4,Q,28.928373353362005
172591,2067,3,2,5,R,29.42735948925036
18870,2067,5,1,6,P,29.389135399042587
155888,2067,6,0,6,E,29.219361807488657
42829,2068,5,1,6,E,28.91338771416292
113423,2068,4,2,6,P,28.80145097881929
173370,2067,3,0,3,F,29.460837443962102
148558,2068,6,1,7,M,29.138138955371083
37967,2068,5,1,6,Q,28.920308260893517
61597,2067,7,2,9,A,28.96531484207267
100973,2068,5,2,7,I,29.087091897859104
17790,2068,5,2,7,Q,28.664415938936045
128024,2068,3,0,3,E,28.912924370550368
167878,2068,3,3,6,M,28.864862839651284
156242,2068,3,2,5,Q,29.13034748675332
143861,2068,4,1,5,M,28.92956018761633
69084,2067,4,3,7,F,29.08080802484385
143004,2068,4,2,6,M,28.96005664324282
86085,2068,5,1,6,K,28.83279151778913
87103,2068,3,2,5,Q,28.64997443000031
19963,2067,4,0,4,P,29.17264110841037
181161,2068,7,1,8,M,28.68379469207525
156758,2067,6,0,6,Q,29.379816297899865
93551,2067,4,0,4,S,29.107535646662058
32825,2068,3,2,5,E,28.805455196116075
47642,2068,1,1,2,D,28.980118134219904
110309,2068,2,0,2,J,28.60746085480857
182398,2067,7,1,8,M,29.03504982620637
86306,2067,4,1,5,S,29.371950780099016
157325,2068,4,1,5,S,28.720161959876727
130568,2067,6,0,6,K,29.26574022964346
165480,2067,3,1,4,I,29.00233573461253
104908,2067,3,0,3,N,29.28207631711107
29766,2068,7,2,9,J,28.79235074198344
55624,2067,4,2,6,M,29.10678352880392
78364,2067,5,0,5,P,29.358199715718648
100776,2068,4,0,4,J,28.65919158720491
148879,2068,6,1,7,M,28.98718162595845
144216,2068,9,0,9,Q,28.829068269924356
32222,2068,4,0,4,E,28.866179933049665
149669,2068,2,3,5,M,28.578344627725112
37849,2067,5,2,7,K,29.024957054472686
89990,2068,4,1,5,K,28.746637128059685
33757,2067,1,3,4,M,29.23425777897664
121989,2068,3,1,4,J,28.8165971210319
145671,2068,7,1,8,K,28.495698506576502
86091,2067,9,2,11,H,29.118916389025305
16459,2068,9,3,12,I,28.916525463488934
180978,2067,4,1,5,N,29.18232884088667
151392,2068,5,1,6,M,28.797482767962627
127510,2067,6,2,8,M,29.45608197134198
74846,2068,6,1,7,D,28.8273085016644
22775,2068,5,3,8,D,28.86555583498933
28416,2068,4,2,6,E,28.70355616185781
147900,2067,6,2,8,M,29.33186644259244
50722,2067,3,2,5,E,29.27599721199649
61971,2067,6,1,7,E,28.85208851998337
139608,2068,6,2,8,Q,28.760683629617574
166201,2068,2,2,4,N,29.044168311880256
89432,2067,5,2,7,D,29.18323084553128
134057,2068,4,1,5,N,28.789436156229232
114417,2067,6,2,8,J,29.24554161679197
77325,2067,7,0,7,E,29.08184421213365
60849,2067,7,3,10,J,29.09121745373394
149747,2068,5,1,6,Q,28.91619374648775
142364,2068,4,2,6,P,29.238040215435948
156723,2068,6,2,8,M,28.894266653862505
73690,2067,6,1,7,J,29.054513657438523
47649,2067,6,0,6,N,29.1208811280765
67427,2068,2,1,3,K,28.78445893395104
178445,2068,3,2,5,N,28.674774623073866
125073,2067,3,0,3,K,29.230605887108595
26594,2067,2,1,3,Q,29.154430456001595
137779,2068,4,1,5,J,28.65531365056039
30160,2067,2,1,3,D,29.08325278955024
100964,2067,3,2,5,E,29.34418200481853
171374,2068,4,2,6,Q,29.070463161208178
137363,2067,4,2,6,E,29.345925880792777
111800,2068,5,2,7,M,28.75386646901698
63040,2067,4,1,5,J,29.437282766525176
144767,2067,4,2,6,M,29.097637369147364
48986,2067,7,0,7,N,29.025205560823405
70457,2067,4,1,5,P,29.24161063198744
49601,2067,3,1,4,E,29.33622425896504
47236,2067,2,0,2,N,29.4428248085394
38459,2068,5,0,5,N,28.95121234872744
164224,2068,3,1,4,M,29.02767085797629
138458,2068,6,3,9,E,28.915187549606923
177485,2067,6,0,6,Q,29.401280641510805
148416,2067,8,2,10,J,29.377757914277264
165214,2068,4,2,6,K,29.23835171588768
103991,2068,7,2,9,J,28.88401015411098
157137,2067,8,2,10,D,29.036590893384798
51699,2067,5,2,7,N,29.18281321597493
165081,2067,4,0,4,M,29.17003741780598
164986,2068,6,4,10,M,28.66749502158049
165801,2067,1,3,4,Q,29.161294574010192
81551,2068,2,1,3,P,28.729671793154967
31864,2068,8,1,9,E,28.67632240055237
138824,2068,5,1,6,F,28.820372112731107
71403,2068,6,2,8,M,28.77383248530735
174272,2068,4,1,5,E,29.13542569116516
47242,2068,6,0,6,D,28.6594850838482
73694,2068,3,1,4,P,28.79078429884537
166427,2067,4,1,5,Q,29.012525339288278
91580,2067,1,1,2,N,29.375872791426552
93291,2068,6,0,6,N,28.91205894865755
46355,2068,5,1,6,P,28.62696805238725
171528,2068,4,1,5,D,28.77205811499019
62329,2068,6,0,6,N,28.90369906976491
17180,2067,4,1,5,P,29.173922349788448
56121,2067,9,1,10,P,29.272786824944443
54598,2067,5,1,6,Q,29.292222442491937
82517,2067,3,1,4,N,29.21495607271625
74402,2067,5,1,6,Q,29.455139761351205
149000,2068,7,1,8,M,28.76542810462406
111224,2068,5,2,7,E,29.038460656716108
111948,2068,6,2,8,M,28.83720094987291
143001,2068,7,1,8,Q,28.78732669789933
175944,2067,5,1,6,N,29.05046809976375
67958,2067,3,0,3,E,29.063299394766187
109991,2068,4,1,5,E,28.71364380321363
41695,2068,11,5,16,A,28.84700517919834
163383,2068,2,1,3,K,28.69167764480564
147781,2068,7,1,8,J,28.98460710864662
136657,2068,4,2,6,E,28.697207509299705
104854,2068,4,0,4,Q,28.832311932226897
55425,2067,4,2,6,M,29.177851820605856
110629,2067,3,1,4,H,29.57277387533591
182388,2068,7,1,8,D,29.033254727176896
62727,2067,8,2,10,E,29.08166479265438
127952,2067,5,0,5,Q,29.00546961467053
50358,2067,6,0,6,S,28.823826017929846
61337,2067,5,1,6,J,29.32112648166831
48069,2067,2,3,5,E,29.1586853276917
128218,2068,4,2,6,J,28.88346598091088
99218,2068,5,2,7,J,29.02460018592451
18249,2067,4,3,7,Q,29.529774090516533
169537,2067,4,2,6,N,29.30117537696829
150656,2068,5,2,7,M,28.98729991906571
120866,2068,3,0,3,S,28.99732450836733
99188,2068,4,1,5,I,29.06156223180545
147742,2068,8,1,9,M,29.147193250451213
53528,2068,6,0,6,Q,28.641241996407185
78392,2068,4,3,7,P,28.898482032542383
55685,2068,1,3,4,M,28.71034302696724
24379,2067,7,0,7,P,28.93449611972397
73349,2067,3,0,3,M,29.17135533577861
63325,2068,3,2,5,E,29.01914418619476
69252,2068,4,2,6,E,28.975369576996997
115939,2067,5,3,8,P,29.53372343392578
44579,2067,3,1,4,P,29.04744362626657
61674,2067,6,2,8,E,29.40014973365537
72661,2067,6,2,8,P,29.08775164177135
115258,2067,6,0,6,J,29.181530782890903
140054,2068,3,2,5,K,28.903358804647567
91959,2067,4,1,5,D,29.08251833272922
89378,2067,8,3,11,J,29.271963048369265
29472,2068,10,2,12,H,28.879638720692935
31380,2067,3,1,4,S,29.35499157468532
115499,2067,5,2,7,J,29.181089084367937
15823,2067,6,2,8,P,29.33302281564085
110891,2068,5,2,7,E,28.931293755820978
123652,2068,4,1,5,K,28.74987724968078
136790,2067,7,1,8,D,29.026662433061144
82293,2068,8,0,8,N,29.0681132053223
131370,2067,2,2,4,A,29.13142895716925
62464,2068,4,2,6,E,28.54884467997098
24613,2068,4,2,6,N,28.564051787553307
132900,2067,3,0,3,N,29.198887685415603
120249,2067,6,1,7,E,29.00235515233496
78182,2068,7,1,8,J,28.69150444125101
160684,2068,8,1,9,E,29.209550040593975
35925,2068,5,5,10,K,28.78545164455289
176458,2068,4,0,4,N,28.683347433140664
138450,2067,4,2,6,Q,29.432535706810064
69168,2067,6,2,8,Q,29.107293813798048
35565,2067,8,3,11,F,28.87842234644144
109865,2067,4,2,6,J,29.145382757937625
119780,2068,0,3,3,N,28.651682954151266
108533,2067,8,3,11,K,29.33874694012476
129184,2068,3,1,4,J,28.727030298176462
76456,2068,3,1,4,L,29.071593185295487
178667,2067,7,0,7,D,28.885476015589003
139649,2067,5,1,6,N,29.279685656303386
143979,2067,6,1,7,F,29.19573617000833
92066,2068,6,3,9,D,28.83569603196885
91596,2068,5,1,6,J,29.13062479140582
118904,2068,5,3,8,E,28.677696268186605
162498,2068,4,2,6,M,28.619902708821343
104149,2067,5,1,6,E,29.111442194379453
93502,2067,2,1,3,P,29.27015893732469
92022,2068,6,1,7,D,28.915595890615386
18903,2067,2,0,2,N,29.15827401487964
178510,2068,3,3,6,F,29.037891669868856
92984,2067,3,2,5,N,29.34671395418304
119556,2068,6,0,6,H,28.88985460280125
148572,2067,6,2,8,E,29.24066935815734
53497,2068,2,2,4,Q,29.12987099413464
157644,2068,12,4,16,Q,29.170410850524917
76716,2067,3,1,4,E,29.276936902762746
24333,2067,1,2,3,K,29.112040724614022
50603,2068,6,3,9,P,29.056772828826684
39695,2067,3,2,5,D,29.195722273877145
145012,2067,0,2,2,E,29.37502627095628
95188,2068,1,2,3,E,28.61661393585616
132190,2067,6,0,6,E,29.30670694152722
143914,2068,4,3,7,Q,28.97172035853093
127875,2068,7,2,9,P,28.733561821184555
100352,2067,3,0,3,N,29.43465521646936
137426,2067,5,0,5,J,29.14319087998578
64065,2067,3,4,7,D,29.42132661040305
148772,2068,9,1,10,N,28.91879367283484
121892,2068,1,3,4,E,28.921621336172
124926,2067,2,3,5,P,29.3084607528013
121740,2067,2,1,3,E,29.301308772657155
31113,2068,5,0,5,E,28.67677875165759
128943,2067,6,3,9,D,29.250104956063627
76016,2068,2,3,5,K,28.94606839170661
98109,2068,7,0,7,E,28.79899555752785
130610,2067,4,0,4,P,28.933591139812723
69703,2067,4,1,5,P,29.41039373757581
99767,2067,3,0,3,Q,29.09416140509619
167381,2068,3,2,5,N,29.073324224611973
145837,2068,4,2,6,M,28.80878972052268
64846,2068,8,3,11,J,29.108786121552058
38511,2068,9,5,14,K,28.83500142704209
57287,2068,4,2,6,P,29.08307682549933
117686,2067,10,3,13,E,29.205185821076626
48287,2067,5,1,6,E,29.099332725460386
94581,2068,7,0,7,J,28.59043368066474
173166,2068,4,3,7,E,28.84339660935186
148771,2068,7,1,8,Q,28.92845037479393
63183,2068,5,4,9,E,29.26044742694822
180458,2067,4,2,6,E,29.261843633211885
39925,2068,10,2,12,D,28.468254025019057
132891,2068,1,4,5,K,29.075138125427443
71220,2067,7,1,8,A,29.34290715677087
115191,2067,6,1,7,D,29.23299574689976
128114,2068,5,2,7,E,28.84923706605248
96161,2067,4,1,5,N,29.3666104803536
122093,2068,7,2,9,S,28.737034739247644
37127,2067,4,1,5,M,29.38321760139618
106172,2067,5,3,8,K,29.43699028888699
73736,2068,5,1,6,Q,28.79781907243648
104662,2067,5,2,7,E,29.28824990904441
52096,2068,2,0,2,J,28.998894640375003
81694,2068,4,1,5,Q,28.359011984292543
149185,2068,4,3,7,M,28.93021952765646
76868,2068,2,4,6,S,28.80139539314704
53991,2067,6,1,7,K,29.10038199273461
120908,2067,2,2,4,K,29.303342233718308
81500,2068,16,3,19,D,28.59291314763165
68867,2067,4,2,6,N,29.436764297046423
95441,2068,3,2,5,C,28.6357740595462
23516,2067,6,2,8,E,29.006093343737767
135093,2068,2,0,2,Q,28.78538768106701
125009,2068,6,0,6,M,28.888728375579635
170598,2067,4,1,5,E,29.1790559793034
176576,2067,4,1,5,D,29.24518541731105
59450,2067,2,2,4,E,29.26697433785211
74493,2068,3,1,4,N,28.60883534265168
47515,2067,1,2,3,I,29.138649411568863
141943,2068,3,2,5,M,28.80140112066196
30959,2068,5,0,5,M,28.657889252304237
143801,2068,4,2,6,Q,28.694842059345557
141943,2067,5,2,7,M,29.150973259326097
41019,2068,6,3,9,J,28.573552347772456
111175,2067,3,1,4,I,28.98288623014517
30492,2067,9,0,9,E,29.15591336510803
19063,2067,9,0,9,N,28.96252274999164
151002,2068,7,0,7,M,28.79419379394544
25317,2068,11,2,13,D,28.771817877537124
37322,2068,11,2,13,J,29.007365519879745
156094,2068,4,1,5,J,28.96125113759948
110481,2068,6,1,7,M,28.864051009371227
123977,2068,4,3,7,K,28.717945841215958
177035,2067,3,1,4,M,29.616406221432246
104195,2068,7,1,8,N,28.805369398955808
69799,2068,7,2,9,J,28.99782590311445
20318,2068,2,3,5,N,28.51231835904852
87299,2067,3,3,6,J,29.1442034777963
19779,2067,4,2,6,J,28.85324415243507
132359,2067,1,4,5,A,28.990070232227023
161893,2068,6,1,7,N,28.47103878726891
82673,2067,2,2,4,P,29.06813256688321
97678,2068,3,2,5,P,28.72829547833396
44980,2067,9,1,10,E,29.236958614425124
24987,2067,2,0,2,N,29.27595294778633
102778,2068,3,1,4,N,28.54045439241205
157240,2068,4,2,6,C,28.79334692688773
40242,2068,2,1,3,Q,29.17450517046508
82120,2068,3,2,5,S,28.90675904337641
150404,2068,6,2,8,J,28.68537748570573
95779,2067,6,0,6,Q,29.056570963962283
128984,2067,3,2,5,M,29.105048940226038
77839,2068,5,3,8,Q,28.82517388440053
99518,2067,3,2,5,N,29.17470936801361
38727,2067,6,1,7,M,29.03898385226044
147167,2067,5,1,6,Q,29.119987414190625
143522,2067,5,1,6,E,29.1353677027965
142963,2068,4,3,7,M,28.84099343823152
170359,2068,4,1,5,Q,28.827044685899843
157384,2067,0,3,3,D,29.097003481138085
103967,2068,6,3,9,L,29.02375202708991
157964,2068,3,2,5,Q,29.09779951819653
24491,2068,8,2,10,J,28.69518920160771
182587,2068,5,3,8,Q,28.92550858760223
100727,2067,1,3,4,J,29.010567688848464
30118,2068,9,2,11,S,28.80119609298578
161423,2067,2,1,3,M,29.1975814224596
104563,2068,3,1,4,Q,28.87178702533029
109296,2068,3,1,4,E,28.839074848435928
51832,2068,3,0,3,Q,28.621579191402404
69844,2067,5,2,7,N,29.22906510253968
133307,2067,5,2,7,J,29.2674229285504
174251,2067,2,0,2,Q,29.02889602570015
31198,2068,8,0,8,C,28.88895345048248
134503,2068,6,0,6,E,28.90441037785698
169318,2067,6,1,7,D,29.53117793253413
115962,2068,8,1,9,P,28.678934954140143
56683,2068,7,1,8,M,28.689975471494463
34550,2068,2,3,5,Q,29.006415050078985
30401,2068,5,1,6,D,29.08901158438494
49372,2068,6,1,7,S,28.45571845148438
36650,2068,4,1,5,J,29.14818448912332
93722,2067,2,1,3,K,29.315937085767512
52012,2067,4,1,5,Q,28.869080337452036
91854,2068,8,1,9,H,28.967671020772052
54763,2068,2,0,2,N,29.20025977298628
73725,2067,5,2,7,E,29.23015843694072
123580,2067,7,2,9,D,29.14411300707467
110309,2067,2,1,3,J,28.855395717732875
25761,2068,8,0,8,D,28.981544020097967
165283,2068,2,3,5,P,29.126510851097997
139499,2068,7,2,9,P,28.8491256775856
92657,2068,4,2,6,N,28.8711982873598
129315,2068,1,1,2,E,29.085633906396705
46223,2068,6,1,7,E,28.922198347455364
35480,2067,5,2,7,J,29.385579744287742
113817,2067,4,3,7,N,29.224688236390957
63704,2068,2,1,3,P,28.87841601355782
31209,2067,5,2,7,D,29.031152403706567
156298,2067,2,1,3,M,28.939462766732223
89467,2067,6,0,6,M,29.339820498347137
20479,2068,4,0,4,E,28.84415230475332
141418,2067,6,0,6,Q,29.28908791645137
182287,2067,2,1,3,K,28.874213047893555
21782,2068,3,3,6,J,28.912337479756577
139681,2068,8,1,9,K,28.88231362572434
84519,2068,4,1,5,J,28.9378180908058
167149,2067,5,0,5,Q,29.03035049658969
144275,2067,5,1,6,P,29.268955137753963
94572,2068,3,1,4,N,29.321909693458863
160418,2067,3,2,5,N,29.08981617294065
25255,2068,3,0,3,C,28.922626766494933
131472,2068,6,3,9,P,28.887824812726475
101812,2067,2,2,4,J,29.23857686979873
109849,2068,3,2,5,E,28.767129946883177
177806,2068,3,1,4,P,28.971003048268624
172747,2068,2,2,4,E,28.934165654895835
127494,2067,4,0,4,M,28.66758119996051
144986,2068,2,4,6,M,28.801269445691396
31644,2068,6,2,8,J,28.85569268582838
111446,2067,5,0,5,J,28.88834300213665
115457,2068,4,0,4,E,28.94740734035138
98311,2067,12,3,15,J,28.976342330824707
120834,2068,5,0,5,N,28.726047836581152
26527,2068,3,0,3,E,28.733660881200468
41581,2067,6,0,6,E,29.24978839333146
127432,2068,4,4,8,E,28.754699669009405
93190,2068,6,2,8,A,28.716076480450127
150506,2068,3,0,3,E,28.95537113467312
71465,2068,2,3,5,E,29.09969540404369
156550,2067,4,3,7,D,29.09326721097869
17841,2067,2,0,2,I,29.365653695198016
177101,2067,4,3,7,E,29.364304909612542
113310,2067,6,1,7,E,29.454413098076277
145862,2067,6,3,9,M,28.96423643869678
132311,2068,8,1,9,N,28.94557573444885
48760,2068,12,1,13,A,29.25105695897452
73960,2068,6,0,6,N,28.79632016034002
121755,2067,5,0,5,Q,28.857395870416603
40327,2068,4,3,7,N,28.82879947679671
133151,2067,7,1,8,E,29.003325486430825
46848,2068,3,0,3,D,28.976323475993247
51081,2067,2,3,5,S,29.212385672442576
75371,2068,2,1,3,M,28.654053054219258
164236,2067,5,2,7,C,29.20089895039402
55698,2068,5,1,6,M,28.876671953737425
44438,2068,3,0,3,C,28.77329805661645
61040,2067,5,2,7,E,29.33535487244923
173263,2067,6,1,7,K,29.06486395417003
110171,2068,6,0,6,N,28.809822197581035
133100,2068,2,2,4,S,28.604948161311448
22532,2067,5,2,7,S,29.403676825465475
133289,2068,5,1,6,N,29.18457570560931
67125,2068,5,2,7,I,28.563811564377517
66297,2068,6,1,7,E,29.00036623815905
118543,2068,6,0,6,D,28.84509233252964
178889,2067,7,0,7,Q,28.870246145671
25219,2068,8,2,10,N,28.73800649012368
70484,2068,3,0,3,N,28.902062951288684
147024,2067,10,0,10,E,28.84963292268994
114419,2068,6,2,8,J,29.1750951223511
93716,2068,5,0,5,N,28.81447474198326
35612,2068,4,2,6,C,28.52263091625719
24259,2068,3,2,5,Q,28.831380265767635
51442,2067,3,2,5,F,29.23348377413232
23892,2067,3,4,7,A,29.12575889639385
170330,2067,4,3,7,E,29.189835872889912
176091,2068,5,1,6,P,28.80777344658436
130398,2067,4,0,4,N,28.973403128934105
124071,2067,1,2,3,F,29.20386255153168
159925,2068,2,4,6,C,28.775239993596287
82452,2068,5,1,6,N,29.13756035996668
68529,2068,5,2,7,I,28.66339312874525
96710,2068,5,2,7,Q,28.517073401035848
136562,2067,4,2,6,K,28.886896714902814
25742,2067,5,1,6,D,29.31452053135918
93618,2067,4,1,5,N,29.39203148489749
51233,2068,4,1,5,A,28.966523059854776
141010,2068,4,4,8,M,28.689455268054243
59391,2067,3,1,4,E,29.22737581422029
24236,2067,5,2,7,N,28.959792320813627
119486,2068,6,1,7,F,28.702419076207647
120984,2067,5,1,6,P,29.349121622765157
161785,2067,5,2,7,K,29.24796914037904
145752,2067,5,1,6,E,29.6202020900897
119809,2067,4,1,5,E,29.40406311869695
42897,2068,4,0,4,J,28.965530206140592
138972,2067,3,3,6,E,29.381295802399716
167692,2067,6,0,6,A,29.198244059002835
131965,2068,2,0,2,N,29.1306716134079
124468,2068,2,0,2,K,28.5069188718624
18005,2068,3,0,3,P,29.003125290891315
79211,2068,5,1,6,D,28.97155747248321
68415,2067,5,1,6,D,29.00687985579147
63685,2067,2,2,4,K,29.05240036048748
165957,2068,3,2,5,S,28.95237636006516
102713,2068,4,0,4,E,28.656194653591548
59485,2068,5,0,5,D,28.74709459715708
39956,2067,5,1,6,D,28.914505902113696
183127,2068,5,2,7,M,28.513820798475574
127049,2067,3,0,3,J,29.16522643652011
37903,2067,1,3,4,E,29.1985886317878
127975,2067,5,2,7,M,28.71641161871167
145340,2068,5,0,5,N,28.80851673569038
150709,2068,2,0,2,A,28.738197478711665
157921,2068,1,3,4,M,28.97246357963998
32571,2067,7,2,9,K,29.30210183742217
26317,2068,4,0,4,N,28.82215832338808
114252,2067,8,4,12,A,29.338262800759036
73782,2068,4,0,4,Q,28.48118895406379
37476,2067,2,1,3,K,29.009530077672444
138470,2068,4,1,5,K,28.955435205915126
83994,2067,3,0,3,J,29.46681244130456
148099,2068,6,1,7,D,28.93827566245584
86207,2067,3,2,5,M,29.083383528647328
116218,2067,2,0,2,P,29.29543308561676
93497,2068,3,2,5,N,28.72007717661821
139490,2068,6,2,8,A,28.66593327169001
70481,2067,2,2,4,E,29.323029363720394
94160,2067,9,2,11,Q,29.09688114384312
145176,2068,4,2,6,N,28.74006590244819
45523,2067,7,0,7,N,29.10000942158056
94293,2068,6,1,7,N,29.01927490809524
18697,2068,5,3,8,P,28.459314027787787
162294,2067,4,2,6,E,29.23201928954545
147882,2067,5,0,5,E,29.17062386229409
147884,2067,2,3,5,M,29.3255156958476
37277,2067,2,2,4,P,29.101121333966557
177180,2067,5,4,9,J,29.279738675066145
83691,2067,1,2,3,H,29.14330998655671
158294,2068,7,1,8,P,28.70750105117758
47305,2068,4,3,7,M,28.94734304648345
37415,2068,4,0,4,E,28.911556927856395
59340,2068,2,0,2,N,29.05704723780464
84852,2068,2,1,3,Q,28.973977778249957
68739,2068,6,0,6,N,28.917631831468213
144564,2067,3,1,4,N,29.009731641447
38829,2068,4,3,7,Q,28.68509213985808
24501,2068,3,2,5,E,28.903537335426
177664,2067,3,2,5,P,29.145468668200166
134456,2067,6,5,11,J,29.07816953640948
121495,2067,3,3,6,P,29.45809624977919
51479,2068,4,1,5,P,28.956386348404497
149427,2068,2,3,5,M,28.74899829027626
67473,2068,2,3,5,J,28.939294690140063
138863,2067,6,2,8,J,28.923014387567136
120428,2068,6,2,8,E,29.072807239249627
23535,2067,3,1,4,E,29.51857873055677
91879,2067,8,2,10,E,29.27702668504254
175022,2067,6,1,7,N,29.214364178246736
30801,2068,1,2,3,N,28.82956692460873
113219,2067,4,2,6,D,29.07587949542072
117027,2068,2,2,4,P,29.16187342860811
155933,2067,4,1,5,P,29.186483951628844
54660,2068,7,1,8,D,29.28710426893304
144654,2067,5,2,7,M,29.18073608637029
131696,2067,4,3,7,M,29.15867294718946
145431,2068,3,1,4,M,28.492326463889206
28212,2067,6,2,8,J,29.185968537991133
108580,2068,3,2,5,N,28.99842242555425
27489,2067,6,0,6,Q,28.899389996354685
120622,2067,5,0,5,E,28.933426295304088
50238,2068,4,1,5,E,28.892886823842897
171444,2067,6,2,8,E,29.450593308459936
169391,2067,6,2,8,Q,29.15347955714349
135367,2068,3,2,5,A,28.95329324298726
19425,2067,3,0,3,M,29.25214196899657
157511,2067,4,3,7,K,29.061678813428472
114321,2068,3,2,5,E,28.56896948182152
37001,2067,3,0,3,F,29.278677673727497
139587,2068,5,0,5,J,28.93853643717101
27840,2067,4,2,6,A,29.007025741438227
20917,2067,5,2,7,H,29.312797967641316
18473,2067,3,1,4,A,29.171680612128483
60827,2067,3,1,4,R,29.135749731272394
161338,2067,2,0,2,H,28.927183975014195
132314,2068,3,3,6,M,28.659240617815545
142795,2068,4,1,5,N,29.41306655842949
159407,2068,4,0,4,S,28.97019997218761
28270,2068,5,1,6,N,29.00844943448733
136765,2068,5,0,5,H,28.79950201873581
72661,2068,5,2,7,P,28.74439096750997
78637,2067,7,1,8,K,29.47278146725672
116133,2067,6,2,8,N,29.122665022857674
135164,2068,6,0,6,E,28.67336850292044
133984,2067,6,1,7,M,29.52021247481721
108357,2067,4,0,4,K,29.072608066779623
123567,2068,6,2,8,A,28.60555965459798
124173,2067,5,3,8,I,28.906195415590627
132239,2068,4,0,4,E,28.52787620080117
22055,2067,4,2,6,M,28.980709256831236
59305,2068,3,2,5,D,29.060159684412035
96650,2067,6,1,7,Q,29.13976206289354
89000,2068,4,0,4,E,28.71459561354275
174956,2068,6,1,7,N,28.499318323023328
33353,2067,5,0,5,E,29.134506367267893
143957,2067,4,2,6,E,29.58436682546489
143296,2068,6,1,7,P,28.96910870163327
139206,2068,5,2,7,P,29.032348918163574
144493,2067,2,1,3,E,29.37138541355577
182532,2068,2,2,4,Q,28.690744722457552
144020,2067,2,3,5,S,29.453773584671456
138989,2068,4,3,7,Q,28.8355344954029
18347,2068,10,6,16,L,28.761828670018048
172355,2067,7,1,8,E,29.319044879398398
117504,2067,8,1,9,E,29.20829793913152
96937,2068,3,0,3,Q,29.00993183326814
165982,2067,2,1,3,Q,28.85748552496668
146082,2068,7,1,8,C,29.139052561852093
53470,2068,6,0,6,J,28.82997770968692
177254,2068,6,1,7,P,28.610976178713223
54507,2067,2,0,2,S,29.1923349696082
130886,2068,3,0,3,M,28.548866567493857
89916,2067,2,2,4,C,29.2689605564638
181661,2068,5,0,5,Q,28.922357925422556
172704,2067,3,3,6,D,29.20388015196516
92512,2068,11,2,13,P,28.99540376441786
177603,2067,0,2,2,N,29.35649396868706
63484,2068,4,0,4,N,29.006418067768585
182456,2068,8,2,10,M,28.66779758751555
34323,2067,6,0,6,Q,29.00552730568141
59059,2068,2,0,2,D,28.739327701293647
82007,2067,3,3,6,J,28.955539853628583
156707,2068,8,0,8,E,28.92584418559137
16279,2067,4,1,5,Q,29.108860015243724
133803,2067,2,2,4,J,29.31873679883241
44722,2068,4,2,6,N,28.677238856818697
24320,2067,4,2,6,N,29.32161262085148
171074,2067,7,0,7,H,29.43581657792266
135291,2067,6,2,8,Q,29.362694473399436
170623,2067,6,0,6,E,28.86263139681392
56693,2068,4,0,4,P,28.716675644933368
181927,2068,10,2,12,P,28.977869030820635
157495,2067,5,1,6,N,28.86352901955372
26366,2067,4,3,7,I,29.549102862110228
129111,2068,2,0,2,K,28.5241359412781
132528,2067,7,3,10,K,28.9291983977856
54710,2068,2,3,5,N,28.83808297828288
151239,2068,6,2,8,M,29.162555649866075
142629,2067,4,2,6,K,28.942813212206087
170758,2067,2,2,4,E,29.13450122574938
52409,2067,3,0,3,A,29.222267391319573
76858,2068,7,2,9,Q,29.104132481301573
92148,2067,1,4,5,J,29.11763092524805
150836,2068,7,2,9,E,29.189660080732004
84897,2068,8,0,8,A,29.273479175321707
58790,2068,4,1,5,E,28.68260014525378
83569,2068,1,3,4,E,29.095486489923427
29088,2067,7,1,8,J,29.145786435556754
74868,2068,6,2,8,N,28.770365843104376
29932,2067,5,0,5,E,29.115530229340862
42837,2068,3,0,3,P,28.9218725269868
50159,2067,4,0,4,E,29.159745944954675
28491,2067,3,0,3,M,29.25366930761606
143013,2068,6,1,7,N,28.85203013319352
42583,2068,5,5,10,M,28.73556780937463
41548,2068,5,2,7,F,28.71057633423867
94740,2068,2,0,2,N,28.740290735095535
122698,2068,5,2,7,S,28.911981995688024
138479,2068,3,2,5,A,28.809629027537323
93555,2068,4,2,6,N,28.54413049007692
172360,2067,5,0,5,A,29.216328575782644
157428,2067,7,3,10,E,29.026169871752813
37432,2067,1,3,4,N,29.022704886036728
157972,2068,10,0,10,A,28.827878952737773
137252,2067,3,1,4,M,29.29334910135439
112079,2067,3,0,3,M,29.164836433033216
63862,2067,2,2,4,J,29.055345817411105
134196,2068,3,3,6,N,28.580769626979983
37198,2067,3,1,4,E,28.867897155888365
133740,2067,2,1,3,E,29.026215411513736
167820,2068,3,0,3,D,28.990068604838783
28660,2067,6,0,6,D,29.130690792257244
100220,2067,6,2,8,K,29.323844441535588
136400,2068,5,0,5,K,28.71370525048521
29472,2067,8,2,10,H,29.27911467827536
82110,2067,4,1,5,E,29.25771473646228
24567,2068,6,1,7,Q,28.931437596454145
111911,2068,9,0,9,E,28.37577748138915
118946,2067,4,4,8,E,29.09126472389975
131570,2068,4,0,4,E,28.80959169399403
169598,2067,7,0,7,D,29.31505491701345
34031,2068,3,1,4,E,28.94645273363702
93730,2067,4,2,6,N,29.504819045279355
74560,2068,4,1,5,D,28.86589208349922
25830,2067,2,3,5,D,29.30682239524913
135556,2067,3,1,4,A,29.281540898567744
46157,2067,4,1,5,N,28.993837193139974
17905,2068,5,2,7,S,29.052541419257143
54660,2067,7,0,7,D,29.270073910449973
87974,2068,6,3,9,P,28.478082600520352
159150,2067,6,0,6,P,29.154209365916252
165746,2067,8,0,8,M,29.340068493415167
64470,2068,11,3,14,Q,28.791368486671743
61804,2068,3,0,3,E,29.035522775534403
54801,2068,4,2,6,N,28.929411937913464
86571,2067,7,0,7,G,28.989190663805275
178494,2068,7,2,9,P,28.89035000407914
26556,2068,3,3,6,M,28.54169196505713
125009,2067,3,2,5,M,29.196110870409825
63218,2067,4,1,5,K,29.143682146285105
86631,2067,4,1,5,N,29.33660689528256
150439,2068,2,3,5,M,28.897031155807174
31762,2067,4,1,5,J,29.232858248698324
104573,2068,2,2,4,S,28.728674896156942
128446,2067,6,2,8,K,28.91752408932257
96075,2067,5,2,7,N,29.33392902562196
158760,2067,4,0,4,N,29.348942323276813
123998,2067,3,0,3,J,29.062093089670128
177386,2067,6,2,8,E,29.231432237280263
53200,2068,4,1,5,Q,28.715759747439773
16943,2068,5,3,8,M,28.79034506082065
175011,2067,4,0,4,N,29.296388335449265
49318,2068,5,1,6,I,28.83362635216061
60688,2068,7,2,9,E,28.701736139045344
60375,2067,4,1,5,E,29.32191488298189
99591,2068,7,0,7,J,28.615989888860454
159292,2068,5,5,10,A,28.746190760814777
48004,2067,2,0,2,D,29.143483608686484
165168,2067,5,1,6,P,29.49255504161775
129654,2067,3,1,4,E,29.33162165208873
179820,2067,4,1,5,K,29.061121710491296
68415,2068,2,1,3,D,28.937805492261724
118823,2067,5,2,7,E,29.150415305098143
75461,2068,9,1,10,M,28.8898340274666
110598,2067,5,4,9,E,29.19294088132808
167746,2067,6,2,8,M,29.187497764374072
49832,2067,2,4,6,E,28.860082644001533
65450,2068,7,1,8,Q,29.0822591046194
101203,2068,3,1,4,N,28.456395960414078
17013,2067,4,0,4,Q,29.26059341121234
145192,2067,8,5,13,C,29.075372633958544
177035,2068,5,3,8,M,28.86046481263426
138771,2068,6,0,6,P,28.82167292603897
49148,2067,6,2,8,P,29.416009757677845
92351,2067,4,0,4,A,29.37649662059785
178710,2068,6,2,8,P,28.925310457909863
141344,2068,2,3,5,M,29.1924930429686
97229,2068,3,0,3,P,28.56806641950957
19190,2067,3,1,4,P,28.99872237403406
103557,2067,3,3,6,E,29.48816908506421
147147,2067,5,3,8,M,29.006879267441875
127484,2068,1,2,3,M,28.74154843566783
93490,2068,2,0,2,D,28.884431451820323
66907,2068,7,1,8,E,28.74245172638869
36721,2067,4,1,5,N,29.10350163511705
22181,2067,2,2,4,N,29.35334434703316
76830,2068,7,1,8,M,28.65505523689114
133772,2067,3,2,5,Q,28.93056739759252
40800,2068,4,3,7,J,28.922780910431
59413,2067,8,1,9,N,29.533617399732336
172317,2067,3,2,5,M,28.51835379631089
133911,2068,6,3,9,N,28.966842182136613
114893,2067,8,0,8,J,29.57119899660313
31752,2067,5,1,6,N,28.949897792019417
82209,2068,5,2,7,Q,28.68513448934897
147751,2068,2,2,4,Q,29.25163438279502
29865,2067,3,1,4,E,29.078928094703045
111675,2067,7,0,7,M,29.292217321433537
36561,2068,6,0,6,D,28.96314292099029
180129,2068,2,1,3,K,28.69115746451996
17543,2067,15,5,20,J,29.139364376492257
167612,2067,5,2,7,Q,28.971910031526644
21897,2068,4,1,5,M,28.67163091479369
16822,2067,2,1,3,R,28.893259126816123
121984,2068,2,1,3,E,28.869425808539557
178632,2068,7,1,8,K,28.937615913998386
84251,2067,3,2,5,J,29.034591859347344
44356,2068,3,1,4,E,28.88753629848001
167501,2068,8,2,10,M,28.816446377138654
132005,2068,4,3,7,A,28.873480376152287
96372,2067,5,0,5,N,29.05534905836569
132642,2068,5,1,6,N,28.63265805861948
156762,2067,6,1,7,N,28.984176630035943
181261,2068,3,1,4,M,29.004631452092887
25266,2067,2,3,5,C,28.726943112454613
172341,2067,3,2,5,D,29.198881056773025
170646,2067,8,1,9,P,29.14723950264998
133640,2067,5,2,7,P,28.89633594496899
122710,2067,4,1,5,C,29.12041932783438
146894,2068,5,1,6,J,28.82887849932251
128177,2067,3,2,5,M,29.142228282815253
49285,2067,2,0,2,Q,29.02507045585185
97319,2068,3,0,3,Q,28.909340664247644
97129,2068,4,0,4,J,28.830372238250632
123868,2067,6,0,6,E,29.03880971480637
127414,2068,4,1,5,E,28.92530448968689
82491,2067,7,2,9,E,29.514190530129063
97926,2068,5,1,6,N,29.027640602916023
54842,2067,5,2,7,S,29.355965316779603
63123,2067,3,1,4,I,29.36665691692173
112205,2067,4,0,4,K,29.22978762554001
137849,2068,2,2,4,C,28.826202868818463
165632,2067,4,2,6,M,29.495036017611824
164194,2067,8,3,11,E,29.370568200386792
93871,2068,6,0,6,N,28.83620187831077
26396,2068,3,2,5,Q,28.71395227696425
112586,2068,7,2,9,E,28.71978479194052
25799,2067,4,0,4,Q,29.20952165475507
40788,2068,8,1,9,M,28.706616578731836
119423,2068,4,0,4,J,28.83676797328592
136843,2067,1,2,3,Q,29.05288193248933
97273,2068,2,1,3,N,28.5809957528526
69392,2067,2,0,2,D,29.60621167921368
107316,2067,3,2,5,N,29.24018184211901
85741,2068,3,2,5,E,28.94155385139126
111564,2067,12,7,19,I,29.238626745201643
173789,2067,6,2,8,D,29.243216383213277
78514,2067,7,0,7,D,28.922626435505
82240,2067,1,2,3,E,29.05570007555353
48680,2067,5,3,8,S,29.028120813946604
162783,2068,3,2,5,E,28.937683676003957
169291,2068,5,1,6,D,28.967162057518195
141308,2068,6,2,8,E,29.117598648995383
110954,2067,6,0,6,E,28.947137321621582
53856,2068,6,0,6,Q,28.970735656310367
166809,2067,4,1,5,N,29.180108250427253
94062,2068,3,2,5,N,29.19990151419629
90151,2068,5,2,7,M,28.831516731334265
106813,2067,1,2,3,M,28.990990676025188
64433,2067,4,0,4,Q,28.75562331411574
73397,2067,5,2,7,K,29.08192114364152
117410,2067,9,2,11,D,29.35308709788788
60151,2067,5,2,7,E,28.96934359749921
170980,2067,3,0,3,K,29.392645794832085
99719,2067,3,2,5,N,29.24013675352128
61911,2068,4,1,5,M,28.97674776158754
55601,2067,3,2,5,N,29.540665084175355
66632,2067,2,0,2,E,29.358768991147663
17476,2068,3,0,3,N,28.577934461102263
55269,2068,3,3,6,N,28.762619944819058
167086,2067,5,2,7,M,29.350482610913765
145362,2067,7,0,7,P,29.246536366893668
33937,2068,4,0,4,M,28.96089210281518
146249,2068,8,0,8,K,28.75807637829696
104603,2067,5,2,7,K,29.286322956285684
101609,2067,5,2,7,K,29.316444927862307
37989,2067,11,2,13,A,28.882723843217672
137041,2067,2,3,5,P,29.303657275138196
158132,2067,3,2,5,Q,29.12278389782884
87292,2068,5,1,6,C,29.053774835564955
55707,2067,5,2,7,Q,29.15853356525868
171459,2068,2,0,2,Q,28.77547655635396
137607,2067,3,4,7,M,29.513624834733044
104149,2068,4,2,6,E,28.85205408117355
180693,2068,3,0,3,E,28.91005077058663
128175,2068,5,0,5,E,28.71043225434331
64859,2068,6,1,7,J,28.85237530573908
130921,2068,3,0,3,E,28.878078598499588
160298,2068,4,2,6,E,28.68403889378127
20489,2067,6,2,8,P,28.955749938722818
134874,2067,5,2,7,P,29.07723666353028
49000,2068,4,3,7,E,29.066357508133965
59653,2068,6,2,8,E,29.231841131933564
86903,2067,6,1,7,E,29.23665594491124
112707,2067,4,2,6,E,29.30240422694149
113711,2067,3,0,3,E,29.45299314776628
41236,2067,3,0,3,J,29.113769198745864
168101,2068,8,0,8,M,28.731126530325007
159412,2068,5,0,5,A,28.72352361939574
72683,2067,3,0,3,K,29.34200216527081
109233,2067,5,1,6,J,29.0660298710393
129319,2067,6,1,7,N,29.01042051091312
116484,2068,5,1,6,I,28.83543456359489
118110,2068,3,0,3,N,28.774321749573375
147196,2067,1,3,4,K,29.314682608718545
156498,2068,2,2,4,N,28.88671601978076
162701,2068,4,0,4,H,28.78977365369023
145763,2067,11,1,12,P,28.962159918698152
51746,2068,6,0,6,E,28.87520194459464
89432,2068,4,0,4,D,28.92122984456746
125955,2068,8,3,11,L,28.70981978506756
59238,2067,3,2,5,E,29.124482466057707
84515,2067,2,2,4,Q,29.295822424815917
156943,2068,4,2,6,Q,28.89651730855016
54115,2068,16,2,18,N,28.931442004781097
86849,2068,2,0,2,P,28.79096584268845
167590,2067,2,2,4,N,29.00232683718342
137426,2068,6,0,6,J,29.18648570914909
100500,2067,4,1,5,N,29.21554159521133
26994,2068,3,2,5,D,28.92570138430707
159354,2067,3,2,5,A,28.782484747364176
62790,2067,5,2,7,D,29.18991089173437
178694,2067,4,1,5,S,29.12717357500402
107745,2068,6,1,7,E,28.803518662628036
27472,2068,8,1,9,D,28.902055908805472
166974,2067,7,2,9,Q,29.149440070610275
89028,2067,5,3,8,P,29.27452254576994
31666,2068,4,1,5,K,28.763238383830515
48401,2067,5,2,7,A,29.187487192631774
139653,2068,4,1,5,N,28.859706956773586
182233,2067,3,2,5,Q,28.979611016193576
163904,2067,5,1,6,M,29.137907731880148
81430,2068,6,1,7,Q,28.79877383145146
19424,2067,3,1,4,P,28.697403997430065
127831,2067,2,0,2,E,29.08387535593285
16188,2068,7,1,8,D,29.082881672642007
41704,2067,3,0,3,M,29.23687511185108
105094,2067,6,1,7,P,29.27094780339648
132255,2067,6,1,7,P,29.15290547959757
162650,2067,4,3,7,J,29.07848495330956
62802,2068,4,1,5,E,28.965582747519864
127345,2068,5,1,6,J,29.114276535561714
56271,2068,3,1,4,F,28.938604175519625
176978,2067,7,3,10,E,29.276613896853146
158132,2068,3,1,4,Q,28.960636088964613
144900,2068,7,1,8,M,28.99739348579927
127175,2068,3,1,4,M,28.979873045974436
146790,2068,3,2,5,M,28.810427018021844
113092,2067,6,1,7,E,29.518302739808828
88777,2067,4,0,4,N,29.06539884864189
66789,2068,5,0,5,M,28.717270884876168
174267,2067,4,2,6,J,28.963893042075117
141786,2067,3,2,5,Q,29.40020211720753
110036,2067,11,5,16,E,29.41098387610217
133340,2068,5,3,8,M,28.804757893894084
127309,2068,3,1,4,J,28.7176537348562
78668,2068,3,1,4,M,28.70616192218773
9116132,2067,17,1,18,D,29.274827798730417
166184,2068,4,2,6,Q,29.02670241471001
39591,2068,3,0,3,K,28.8101809939198
166446,2068,7,0,7,P,28.79268734932933
17612,2067,3,3,6,N,28.842433693428248
93102,2067,4,2,6,N,29.05426275671317
161665,2068,5,1,6,H,28.822701007579138
74883,2067,2,0,2,N,29.10090314938852
104385,2068,3,1,4,K,28.72514876743193
37664,2068,9,2,11,H,29.030344750584824
51683,2068,6,2,8,E,28.714218807965995
46821,2067,2,1,3,A,29.16484506992882
115871,2068,4,0,4,P,28.88172568625407
137709,2068,3,0,3,M,28.73989438939401
133432,2068,7,2,9,A,28.84889134500927
26624,2067,4,2,6,E,29.175263920845456
35810,2068,2,2,4,E,28.71363404320361
78276,2067,5,2,7,J,28.983884024889083
174258,2068,4,1,5,J,28.79229305303293
112753,2068,3,3,6,Q,28.78492363241731
51105,2067,5,2,7,E,29.355546349246623
143709,2067,6,1,7,N,29.4284813992792
94335,2067,4,0,4,E,29.103050671928106
93250,2067,5,0,5,E,29.10569707332819
44715,2067,4,0,4,N,29.271201046795365
81900,2068,4,4,8,J,28.51687979231992
46213,2067,9,4,13,M,29.41629865957322
167290,2067,5,2,7,M,28.968935236284796
110427,2068,6,1,7,D,28.767241067673865
67827,2068,9,3,12,M,28.669806487672048
122288,2068,7,1,8,E,28.7312783419194
171852,2067,5,0,5,E,29.4435977381762
60255,2067,9,1,10,J,29.36425668076811
64364,2068,6,1,7,E,28.5202726929112
37963,2068,8,2,10,P,28.831293983918385
77586,2068,8,2,10,E,28.887104157605386
127299,2068,7,0,7,E,28.7344862825912
66742,2067,2,0,2,M,29.185044406325048
47742,2067,3,1,4,K,29.14358720542972
23887,2067,5,1,6,D,29.21429474050204
24076,2068,3,1,4,J,29.13486643498784
88655,2067,5,1,6,K,29.19461063684413
125007,2068,5,0,5,H,28.66719284480881
113642,2068,8,0,8,N,28.930427202249003
90321,2067,4,2,6,M,29.321374316868116
36779,2068,4,1,5,P,28.9969143109725
97576,2068,7,5,12,S,29.087260338853103
166261,2067,1,3,4,C,28.991018793920954
60095,2068,3,3,6,N,28.78230020071656
59191,2067,5,1,6,E,29.21784489858356
157261,2068,5,4,9,J,28.636013252342373
67596,2068,1,3,4,J,28.98086566264245
17174,2067,10,1,11,A,28.99513050777676
98217,2068,3,1,4,E,28.97385834240537
159407,2067,3,0,3,S,29.23910296969496
129546,2068,5,1,6,K,28.73616735412536
45450,2067,4,3,7,M,29.11346586493151
139985,2067,3,0,3,M,29.20270040717065
103611,2068,15,5,20,P,29.030397517765785
17457,2067,2,1,3,P,29.31989057443256
77640,2068,4,2,6,N,28.882649078442693
69239,2067,2,1,3,E,29.413970859427348
38542,2068,3,0,3,E,28.799242583845647
174286,2067,5,2,7,Q,29.2882172004828
113867,2068,6,3,9,Q,28.899188524889045
117043,2068,6,0,6,S,28.91741988414814
56162,2067,6,2,8,S,29.206468607273838
114981,2067,5,1,6,N,29.1995493432413
67416,2067,5,1,6,E,29.008551323285808
18903,2068,4,2,6,N,28.937091194718107
102656,2067,4,3,7,P,29.158349792161143
90527,2067,5,2,7,M,29.41591137811059
17617,2067,6,0,6,J,29.38180784630989
100055,2067,4,1,5,E,28.956406313679818
108509,2068,6,1,7,Q,28.63114339488439
180950,2067,6,1,7,M,29.154333122090005
116581,2068,7,1,8,N,28.387823737461503
53866,2068,3,0,3,N,28.901830480738155
161008,2068,5,1,6,N,28.832112190542887
146708,2068,1,5,6,P,28.856967264835767
42692,2068,4,1,5,C,28.754885499291515
142295,2068,3,2,5,D,28.89504861111962
105088,2068,3,2,5,J,28.783992567879302
100661,2067,4,3,7,Q,29.056906327861924
19625,2067,2,3,5,M,29.24282059496387
90710,2068,8,1,9,P,28.68612494760301
81284,2067,1,3,4,P,29.14154278235082
136052,2068,7,1,8,Q,28.986937941508447
108116,2068,3,2,5,E,28.774469352815103
170470,2068,6,0,6,A,28.85076011145337
55624,2068,8,1,9,M,28.87397951033053
163552,2068,3,1,4,J,28.94019589435033
99354,2068,1,3,4,F,28.90241534340468
98633,2067,3,2,5,E,29.0846600762966
20707,2067,3,2,5,P,28.95520991391533
50954,2068,4,0,4,E,28.84713240835872
45973,2068,5,3,8,E,28.660908311621878
97998,2067,6,1,7,N,29.286230506798493
17956,2067,8,4,12,Q,29.261761208315328
136364,2067,7,0,7,J,29.35398216284401
111631,2068,4,2,6,M,29.11995149060848
148831,2067,2,2,4,M,28.908233669766357
166193,2068,4,2,6,E,28.643551120875134
158609,2068,4,2,6,S,28.67242001953784
140631,2068,3,1,4,D,28.99702656522989
46007,2067,2,1,3,Q,29.31839726180399
17516,2067,4,0,4,A,29.2269146635995
59914,2067,8,3,11,N,28.992887698151907
132904,2068,5,2,7,J,28.786050107290837
17049,2067,7,2,9,D,29.23956278261761
65031,2068,5,0,5,M,28.74207475555796
110599,2067,2,2,4,J,29.3541467557464
61403,2068,6,1,7,N,28.91248161869455
38916,2067,9,2,11,L,29.46283695927963
98005,2068,2,2,4,Q,29.03570289096854
108520,2067,4,2,6,E,29.038393261485048
41336,2068,6,1,7,J,29.13401151770262
86810,2067,2,1,3,H,29.05047232300764
175603,2067,3,1,4,Q,29.076155257004203
159453,2067,5,3,8,F,29.1522205872349
90745,2068,4,2,6,D,29.219392643947558
32231,2068,4,2,6,E,28.889431691892828
166101,2068,2,2,4,N,29.045921328598148
82110,2068,5,3,8,E,28.80254388224366
144871,2068,2,3,5,A,28.67789192592288
177266,2068,6,1,7,D,28.677460777415423
85335,2068,5,4,9,E,28.655099106517905
59848,2067,6,2,8,E,28.9669980511072
73091,2068,1,2,3,P,29.135123730195144
134544,2067,3,1,4,P,29.06422000219265
90481,2067,6,1,7,F,28.928954528491538
105703,2067,5,2,7,S,28.90936913295348
159442,2068,4,1,5,N,29.0728207607496
87611,2068,1,1,2,S,28.84363397846663
25799,2068,4,0,4,Q,28.808713008494674
124901,2068,4,1,5,P,28.886491935304708
109759,2068,4,1,5,J,29.22587863838485
167081,2067,6,0,6,E,29.16543215375632
36890,2067,5,1,6,M,29.33581047833833
40632,2067,4,2,6,Q,29.186175378715063
20196,2068,2,0,2,N,28.869946072342163
144882,2067,5,2,7,M,28.97178950348312
35884,2067,2,2,4,I,29.162988284917468
148888,2067,1,4,5,M,29.14515110526871
179846,2067,9,1,10,M,29.20658012849194
117452,2067,2,2,4,P,29.51977389801868
75877,2067,7,2,9,D,29.08086549883719
112544,2068,5,2,7,I,28.844956587363047
139743,2067,6,0,6,M,29.1552162663799
61927,2067,8,2,10,D,28.975825401137254
51148,2067,4,3,7,S,29.06396937789737
141444,2068,7,0,7,E,28.877733086596045
74134,2068,5,1,6,Q,28.84269992676406
90449,2067,7,2,9,N,29.25519222560104
98859,2067,5,2,7,P,29.49013630205781
72602,2067,3,2,5,E,29.171523050844005
73051,2067,3,1,4,N,28.999367951775618
31946,2067,4,1,5,J,29.254272931290437
18176,2068,6,0,6,Q,28.96452782113661
144722,2068,5,2,7,M,28.40374622874634
93516,2067,3,3,6,P,29.29209701741926
141854,2068,4,1,5,M,28.86563396744475
99368,2067,5,0,5,E,28.82263563813469
132356,2068,7,2,9,P,29.052769201965862
97457,2067,2,1,3,Q,29.026839229844832
100579,2068,1,3,4,K,28.872815861256083
78037,2067,5,1,6,D,29.137754963705707
158719,2067,2,3,5,Q,29.788114396782916
142624,2068,3,0,3,K,28.901518506032136
172580,2067,2,2,4,D,29.271180562891708
22859,2068,6,1,7,M,28.94539667737064
42649,2068,3,2,5,M,28.89503284768481
51087,2068,6,2,8,E,28.7856024862188
160555,2067,5,1,6,N,29.518485500322196
28174,2068,4,2,6,E,28.75686095313004
27470,2068,4,1,5,E,28.80401858640448
59730,2068,4,3,7,N,28.87427784035637
35526,2068,3,2,5,H,29.002158592765053
103582,2068,2,2,4,F,28.87694067931814
65355,2067,3,0,3,J,29.272011023330137
128218,2067,7,2,9,J,28.89494903960924
45440,2068,11,2,13,A,28.72783984494557
87305,2068,3,2,5,C,28.8461136839416
99513,2067,3,3,6,P,29.162892490421164
47141,2068,4,2,6,E,28.61842948046731
94239,2067,4,3,7,M,29.196396856510148
86979,2067,3,1,4,C,29.47387361725564
173853,2068,3,1,4,E,28.73637145856717
149321,2068,4,4,8,M,28.69340951896713
73529,2068,5,1,6,Q,28.6492134914706
160807,2068,5,1,6,E,28.852796711952976
110287,2068,3,0,3,E,28.74986437194082
129775,2068,4,3,7,L,28.85484272151581
69297,2068,8,0,8,D,28.8677121142124
24814,2067,6,2,8,E,29.08427689509482
171318,2067,5,2,7,Q,29.321317325368668
111891,2068,4,0,4,C,28.66881868302313
132104,2068,6,2,8,J,28.728839105112453
128873,2067,4,1,5,A,29.32655022253057
157659,2067,4,1,5,K,29.08357837086123
180618,2068,7,0,7,N,28.86018507503311
125539,2068,5,1,6,E,28.957677566801465
29620,2068,6,2,8,Q,28.97003077571741
142585,2068,2,3,5,N,28.918448915490263
148791,2067,2,1,3,M,29.394957370501984
17711,2067,0,3,3,N,28.968588147221336
19287,2067,5,4,9,A,29.38831869440217
103510,2068,3,1,4,D,28.83138249890414
137862,2068,5,0,5,K,28.8370378581226
46293,2068,3,3,6,A,28.685535258127167
132401,2067,3,2,5,F,29.133178401743265
181598,2067,3,1,4,Q,28.97104284467521
135270,2068,5,1,6,S,28.73085254532309
151270,2068,2,0,2,M,28.739267724310967
132790,2067,5,3,8,N,29.10997630530331
146463,2068,7,2,9,M,28.917459700468804
145401,2067,3,1,4,E,29.042814828924744
76281,2067,6,2,8,M,29.42356809210812
112824,2067,3,1,4,E,29.117516495083574
147390,2067,6,2,8,M,29.37634760854591
34001,2067,2,2,4,P,29.22320746015557
135704,2068,6,1,7,J,28.910438519535823
118946,2068,6,4,10,E,29.023381049899022
59223,2067,2,0,2,E,29.333479026546502
128031,2067,3,0,3,P,29.3357383385234
177456,2067,1,2,3,N,29.762359862785484
157508,2067,5,2,7,E,29.287880558495907
16300,2067,4,0,4,Q,29.38261957260011
157200,2068,6,0,6,N,29.177139902248047
56322,2067,4,2,6,E,29.206462975641752
102819,2067,5,0,5,N,29.075769606013207
170025,2067,3,3,6,E,29.25034250971701
139257,2067,4,1,5,P,29.220988193976492
130426,2067,5,1,6,P,29.12282610684516
97531,2068,4,3,7,P,28.741635704083244
78249,2068,8,0,8,M,28.67928097422876
148663,2068,5,2,7,M,28.82003572611918
27561,2068,3,2,5,E,28.8852559534885
76315,2067,2,2,4,D,29.094320323175985
33768,2067,3,0,3,M,29.249227503021903
117118,2068,7,1,8,P,28.77361318989785
81688,2067,5,2,7,D,29.25642808608348
93745,2068,5,3,8,E,28.881537356426627
98019,2067,5,1,6,N,29.26480353653437
179257,2067,11,3,14,J,29.33201952184845
136533,2067,5,1,6,M,28.60146069176018
44783,2067,6,2,8,J,29.089611167616432
112545,2068,5,0,5,J,29.161191061227044
112182,2068,3,2,5,E,28.84205266615503
180169,2068,4,1,5,D,28.953334338178003
137058,2068,3,1,4,M,28.847968711111
137272,2068,6,2,8,P,29.13419691532641
74304,2067,5,2,7,P,29.31605630844796
45101,2068,3,1,4,E,29.200061045921057
45788,2067,3,2,5,Q,29.369781193993912
148414,2067,5,2,7,M,29.28168143461178
24970,2068,7,2,9,E,29.08939504324739
78597,2068,6,0,6,Q,29.089551904907538
72630,2067,5,2,7,K,29.331280793593237
157661,2068,9,3,12,E,28.998899928133667
88155,2068,6,0,6,E,29.201133241184657
117129,2067,6,0,6,R,29.371574311211152
129923,2068,4,1,5,I,28.919875905794715
72824,2068,3,2,5,E,28.611387391626668
84111,2068,5,0,5,D,28.942610445325226
110461,2067,4,0,4,E,29.188891474723324
120397,2067,2,0,2,E,28.765713875477022
180959,2068,6,0,6,M,29.032016735122937
48309,2067,4,1,5,D,29.32615024575827
110809,2067,3,0,3,J,29.138388876357716
146552,2068,6,0,6,K,28.7960619801203
79438,2068,4,0,4,N,28.768310145213125
66748,2068,3,2,5,N,28.66434268152717
129253,2068,6,2,8,N,29.088142057545955
158598,2067,4,1,5,Q,28.986109069433688
89512,2067,5,0,5,P,29.39960381531396
174153,2068,4,2,6,E,28.665730880611505
132516,2067,5,2,7,E,29.158519978611498
115534,2068,4,1,5,E,28.87813704134617
101319,2068,2,0,2,E,28.85895265664465
68897,2068,4,0,4,K,28.891681269490025
60240,2067,5,0,5,N,29.18650949799092
26017,2067,6,0,6,Q,29.28995172940648
157389,2067,1,3,4,D,29.009022769179783
70180,2067,7,1,8,H,29.2714240113706
24659,2067,11,4,15,R,29.02166528490982
25439,2068,5,2,7,J,28.852138874060987
141389,2068,7,1,8,E,28.83068382450176
144839,2068,7,1,8,N,29.2255014832464
142979,2068,3,2,5,N,28.643172588214085
38710,2067,3,1,4,E,29.229335203582444
147548,2068,7,2,9,M,29.000329198264204
47451,2068,4,1,5,E,29.059934398154837
137740,2067,6,2,8,P,29.43720235538647
69469,2067,7,1,8,N,29.114757633633925
93125,2068,8,0,8,J,28.70684695448013
94489,2068,5,2,7,E,28.87111157342173
24138,2068,4,3,7,E,28.91703590956924
122669,2068,1,2,3,E,28.91557608558411
157564,2068,3,3,6,N,28.832127750657424
134856,2067,6,2,8,A,29.151225729766686
41960,2068,6,0,6,P,28.83899271364459
146523,2068,2,3,5,A,28.80888948933754
81488,2067,4,3,7,D,29.047271858980466
58990,2068,6,0,6,D,28.850403020619805
50001,2068,3,2,5,S,28.64909771531045
92979,2068,5,2,7,D,29.056581442684596
101708,2067,5,2,7,P,29.05035598243309
36146,2067,3,2,5,N,29.505505821360867
70182,2067,4,1,5,N,29.22912265303795
64246,2067,6,0,6,D,29.105771035435748
151044,2068,6,0,6,M,29.09231101146942
20785,2068,7,2,9,E,29.12764574141126
114432,2068,8,0,8,J,29.13053322218325
157225,2068,6,0,6,K,28.57811095592235
53991,2068,5,0,5,K,28.71915819222155
55755,2067,5,2,7,L,29.342544443598367
68277,2067,5,3,8,E,29.320336135696728
41927,2068,6,2,8,E,28.90917883037708
169423,2067,4,2,6,J,29.28578704292968
42277,2068,5,2,7,C,28.797339439136625
182905,2067,5,2,7,R,28.90832765122347
32920,2067,3,1,4,E,28.966173330065367
132928,2068,7,1,8,M,28.939743254958948
60298,2067,1,2,3,Q,29.168220906052245
64071,2067,2,2,4,N,29.281264177719155
28777,2067,2,1,3,E,29.15583474761823
145498,2067,3,2,5,K,29.050553728716828
60449,2068,1,3,4,J,29.11419909615504
89015,2068,4,3,7,L,29.031010779179244
99029,2068,6,0,6,Q,29.113235979272535
54456,2068,5,2,7,Q,28.92913012834359
18705,2068,5,0,5,K,28.779320336742806
33720,2067,5,2,7,J,29.13438026206837
147428,2067,6,1,7,Q,29.287506740584263
148387,2067,6,1,7,N,29.030813058439147
128658,2067,2,1,3,N,29.04744476277443
171778,2068,3,2,5,P,28.87968533782441
115499,2068,4,0,4,J,28.75366617547198
125283,2067,6,2,8,M,29.419734904511657
159745,2067,1,3,4,E,29.3338324664305
145965,2068,3,2,5,Q,29.09676496433266
175478,2067,1,2,3,J,29.192918513464317
179430,2067,4,2,6,J,29.18208533042061
146175,2067,5,2,7,M,29.180666781159704
123487,2067,5,0,5,K,28.971845114627083
95069,2068,6,1,7,Q,28.78874428972861
99783,2067,3,0,3,Q,29.304401331973168
106333,2068,9,7,16,K,28.97697934991317
165436,2067,4,2,6,P,28.8253771465817
164044,2067,6,1,7,E,29.33751103565269
99611,2068,2,0,2,K,28.725621118166664
92920,2067,3,1,4,E,29.107175435295037
185027,2068,16,3,19,P,28.76888107230453
176661,2067,3,3,6,D,29.00308862860584
81583,2068,6,3,9,E,28.714053919296195
116852,2067,3,1,4,P,29.0558797050861
101866,2067,3,1,4,E,28.88806615485217
118403,2068,4,1,5,K,28.93347974696564
21843,2068,6,0,6,P,28.48982661062826
106095,2067,7,1,8,E,29.49025284352446
27887,2067,5,1,6,J,29.265067798326385
112333,2067,5,1,6,E,29.46375045539168
73658,2067,3,0,3,P,29.060803998750885
89956,2067,6,0,6,D,29.039598710095174
65702,2067,3,0,3,Q,28.9995773570224
169906,2068,5,0,5,N,28.613234676719863
75461,2067,5,2,7,M,29.49238665182088
147637,2067,6,1,7,M,29.385864489302904
97183,2068,6,1,7,N,28.830656833434784
98535,2068,2,0,2,Q,28.56959361850968
166246,2068,5,0,5,K,28.81640822208865
96717,2068,5,0,5,A,28.807504365655177
185025,2067,17,3,20,P,29.410837435471297
111126,2068,9,3,12,D,28.78461628405408
69803,2067,5,0,5,R,28.78565583880193
103901,2068,1,1,2,N,28.73766427328404
120542,2067,2,2,4,E,29.22851267600961
20093,2067,1,2,3,N,29.36055590944332
147703,2068,5,2,7,Q,28.55150447806474
140054,2067,4,1,5,K,29.49951961043332
134470,2068,3,1,4,P,28.74810353172808
26923,2068,3,2,5,A,29.013838239041867
147877,2067,3,0,3,P,29.346091505778947
114757,2068,8,3,11,Q,28.77816662735575
19284,2068,6,2,8,P,28.653605785411077
98397,2067,5,2,7,E,29.244739456631464
76389,2068,5,1,6,A,28.91931938807397
92670,2067,10,4,14,E,28.92002937614945
64606,2067,7,0,7,E,28.95085745499603
143199,2068,5,2,7,P,28.858381758495
112410,2068,2,1,3,K,29.14611249225757
114285,2067,4,2,6,J,29.301764763022025
116353,2067,6,1,7,J,29.31304272160242
44367,2068,3,0,3,E,28.687399487024017
140342,2068,5,2,7,N,28.883524116544404
21481,2068,7,0,7,Q,28.66115473653173
115979,2067,5,2,7,N,29.2794768619639
65880,2067,3,0,3,N,29.081752222744825
140323,2067,4,0,4,K,29.277799038249277
106371,2067,8,1,9,J,28.801741965296355
76915,2067,5,1,6,M,28.95480539039253
122603,2067,7,0,7,E,29.115347773301146
91839,2067,10,5,15,D,29.498150644803577
159286,2068,5,0,5,N,28.860194190359763
95550,2068,6,0,6,N,29.17843289108529
103936,2067,1,3,4,N,29.333981869660995
90649,2068,7,1,8,F,28.532962297539363
142285,2067,2,0,2,M,28.99222799209516
124960,2068,4,2,6,E,28.81879457537652
160313,2068,0,4,4,P,28.742591849665686
169402,2068,2,1,3,A,28.85083640893421
74318,2067,3,1,4,N,29.708028679817296
75832,2067,5,0,5,E,29.511088293688907
115528,2068,4,0,4,D,28.861434683403136
157936,2068,3,3,6,P,28.6743900669469
38224,2068,6,0,6,J,28.876297009465468
78194,2068,2,0,2,Q,28.93938196128835
65173,2068,2,4,6,E,29.096548472504487
26538,2068,3,0,3,E,28.62764013970438
93827,2067,6,2,8,J,28.97543599816029
164921,2068,9,2,11,E,29.02474384215145
95770,2067,2,0,2,S,28.81455648861806
74178,2068,4,2,6,R,29.14309742547325
147453,2067,5,2,7,M,29.263587056338928
102502,2068,3,2,5,N,28.82465769522961
109391,2068,1,2,3,E,28.87628642169401
70621,2068,3,1,4,N,28.90660331065039
45548,2068,4,0,4,N,29.069957937618224
108392,2068,2,0,2,F,28.860097012468017
47939,2067,5,3,8,J,29.191682558037662
101365,2067,3,1,4,E,29.1809314678247
64177,2067,4,3,7,J,29.373306499815893
149290,2068,9,2,11,M,28.82526654229848
66556,2068,2,1,3,E,28.594792621469825
109900,2068,5,2,7,J,28.968911404959687
40711,2068,3,2,5,F,28.827352592458347
20058,2068,5,3,8,E,28.77796216229601
65205,2067,6,1,7,E,29.19096238739125
31494,2068,7,3,10,E,28.996338540715914
101846,2067,0,3,3,E,29.358863872426184
124823,2067,4,0,4,Q,29.084742130932977
112382,2067,4,1,5,M,29.20427247480785
56275,2067,6,1,7,J,28.911568978192605
175270,2068,2,2,4,D,28.83177563770445
169253,2067,4,0,4,J,29.37041410739587
121502,2068,5,1,6,M,28.60023202400232
114638,2068,5,2,7,M,28.757689897467383
92421,2068,9,0,9,N,29.258373186275332
123983,2067,6,1,7,E,29.330483975693827
178570,2068,8,0,8,H,29.23927852448119
113641,2068,7,2,9,J,29.253477308325976
146799,2067,3,0,3,F,29.08875523983078
115382,2067,2,3,5,N,29.279115359849158
29503,2067,2,3,5,E,29.1194729790845
70496,2067,3,0,3,J,29.38718511502428
19062,2067,4,2,6,E,28.98442552588389
111820,2068,4,0,4,J,28.884393270666298
83580,2068,5,2,7,J,29.02194920054896
18525,2067,4,0,4,E,29.34207164532777
118001,2068,4,1,5,E,29.138193104578537
32953,2068,4,0,4,S,29.17671152525135
60139,2067,4,1,5,J,29.339771066647558
124580,2067,1,3,4,N,29.29180548600987
88570,2068,4,4,8,S,28.724266809730008
26777,2067,2,0,2,N,29.206062169788517
147909,2068,6,1,7,M,29.160935239622017
114041,2067,3,2,5,E,29.112814764319303
29856,2068,6,0,6,Q,28.788183715977134
28806,2068,2,0,2,E,29.18744108560056
28335,2068,5,2,7,D,28.76337151047918
59238,2068,0,3,3,E,28.83957840274985
44382,2068,1,1,2,N,29.06918040732564
96654,2068,2,2,4,S,28.71588139176584
36692,2068,3,1,4,Q,28.55880531704296
24194,2068,4,0,4,D,28.83095551261717
178464,2068,3,1,4,P,28.92205476598157
62548,2068,4,1,5,S,28.861306670439102
41809,2068,2,2,4,D,28.98688386162889
91655,2068,7,3,10,D,29.172129087350896
21160,2068,3,3,6,P,28.79338216468481
136698,2067,0,6,6,N,29.247549439886832
41043,2067,6,1,7,N,29.14742479426432
159870,2067,7,0,7,E,29.04648403650621
21253,2068,5,1,6,Q,28.70249927402213
112174,2067,6,3,9,H,28.90564768974554
136997,2067,2,1,3,P,29.19271517149764
172944,2068,2,1,3,N,28.91372885515225
133841,2067,4,1,5,F,29.095250787913766
99838,2068,2,1,3,D,28.88793575388762
81261,2067,7,4,11,E,29.10913460005252
76526,2068,3,2,5,N,28.674924145485743
17705,2067,3,0,3,P,29.1968523122848
61491,2068,5,1,6,N,28.532027417001917
177199,2068,3,0,3,P,28.674388523026582
87786,2068,2,2,4,D,28.708693552218115
137357,2067,3,2,5,Q,29.204664783245104
145896,2067,5,0,5,A,29.33775036745136
149204,2068,3,2,5,M,28.569530263527508
125524,2068,5,2,7,N,28.848578860169933
158869,2067,5,2,7,P,29.136054179846404
35545,2067,6,3,9,P,29.172278421456745
86828,2067,3,1,4,E,29.295893043310976
62974,2068,8,2,10,D,29.13193696567476
127059,2067,5,0,5,S,28.85060847948203
32228,2068,6,2,8,N,28.99079078908618
158389,2068,4,0,4,E,28.78105203543632
101114,2067,6,1,7,P,29.10231917102604
67858,2068,6,2,8,M,29.05419908144937
46209,2068,4,2,6,D,28.661201245852517
72680,2068,7,1,8,N,28.684562853432503
141577,2067,3,2,5,M,29.392732580124704
133832,2068,6,0,6,J,28.74267047611925
96971,2067,4,2,6,M,29.229237942027478
21056,2068,6,1,7,E,28.84778381575638
104549,2067,6,1,7,K,29.511326522906263
177700,2067,4,1,5,N,29.116900609221783
51615,2067,5,1,6,P,28.995751161624867
55001,2068,4,2,6,I,28.65139610319711
148434,2067,1,4,5,M,29.35704928854972
22548,2067,6,1,7,G,29.160739007012516
143995,2068,3,1,4,M,28.526456534128883
19385,2067,5,2,7,J,29.129891374151885
73587,2068,13,4,17,A,28.96893913680753
105366,2068,9,4,13,D,28.616303842800328
103966,2067,3,3,6,Q,29.27302352848864
48952,2067,4,0,4,A,29.186815242437472
78611,2068,4,1,5,D,29.122577706909745
140496,2067,5,0,5,D,29.27077634888224
132426,2068,5,0,5,K,29.00780526468632
61534,2068,4,1,5,N,28.949017268242557
149229,2068,6,0,6,I,28.96426293826766
117133,2068,6,0,6,J,28.91033155903134
60429,2068,2,0,2,I,28.509909044083013
75832,2068,2,0,2,E,28.76064759363737
106820,2067,1,1,2,E,28.920065422454343
115041,2068,4,1,5,M,28.72454950256656
69338,2068,5,1,6,E,28.674578044947044
35634,2067,2,2,4,E,29.23059033186938
41131,2068,4,3,7,P,28.98370741372972
160753,2068,5,2,7,N,28.896938485044704
134348,2068,4,2,6,K,28.99647839830492
120883,2067,2,1,3,M,29.264743072883597
60195,2067,3,1,4,P,28.993150555906745
113640,2068,6,1,7,J,29.094049401603414
105292,2068,5,3,8,F,28.65819202396742
111489,2067,4,3,7,J,29.114515209621487
176712,2068,4,1,5,F,28.91736864794108
145433,2068,7,4,11,M,28.710803897189187
115809,2067,6,2,8,N,28.92039646795347
160179,2067,3,4,7,F,28.941847137713363
45046,2068,4,2,6,E,29.155981878131097
66229,2067,6,2,8,E,29.09779077933957
125220,2067,6,2,8,P,29.181081292688827
88758,2067,3,0,3,D,28.989348962129515
101694,2067,3,2,5,N,29.327160860119942
97941,2068,0,4,4,E,28.866800582535053
176060,2068,5,1,6,J,29.17021193096636
172341,2068,1,3,4,D,28.819173981860065
62212,2067,2,2,4,E,29.037053311873148
52668,2067,5,2,7,E,29.368598747226784
177244,2068,6,2,8,E,28.757736160189157
112749,2067,4,1,5,E,29.00819481806249
129280,2068,6,2,8,K,28.69712099863239
41031,2067,5,2,7,L,29.09269581904153
148498,2068,5,1,6,M,28.98989301658356
15812,2068,8,2,10,E,28.954261506680457
56194,2068,7,2,9,M,28.977061956826923
83931,2068,4,3,7,D,28.57745032235342
117118,2067,10,1,11,P,29.324992293868533
121208,2067,6,2,8,P,29.13711425309456
157090,2067,6,0,6,D,29.10204377697169
41164,2067,3,3,6,E,29.11331727385655
47273,2067,5,3,8,N,29.32652482818765
130536,2067,6,1,7,E,29.290371683602107
100220,2068,9,2,11,K,28.75891197486593
64230,2067,5,0,5,E,29.41300363203739
77504,2067,2,1,3,Q,29.41656754589572
113310,2068,7,1,8,E,28.9168800964864
67497,2067,5,2,7,Q,29.090668327372963
140262,2067,4,1,5,A,29.065941133078123
158621,2067,3,3,6,D,28.97999040196712
46277,2068,6,0,6,P,28.86939615020797
127668,2067,5,2,7,P,29.11028068147053
93546,2068,13,8,21,E,28.630046348966637
47387,2068,4,2,6,P,28.781814369802778
82246,2067,6,0,6,N,29.434812368960092
180042,2067,3,0,3,J,28.948952916156998
84116,2068,2,2,4,E,29.018166207255927
29612,2068,10,1,11,C,28.908647281191417
83853,2068,0,3,3,N,28.632689727307827
156250,2068,8,3,11,A,29.1036301612906
173455,2068,4,1,5,E,28.72242863951371
163503,2067,4,1,5,M,29.0440698587666
125101,2068,6,2,8,M,28.801048955395004
142155,2068,5,2,7,S,28.875341997884348
141490,2068,3,2,5,M,29.109200495490224
157818,2067,5,2,7,K,29.071893215476475
110700,2067,2,2,4,E,29.17591228449085
62968,2068,6,0,6,E,29.040920903211
174492,2068,5,1,6,N,28.85872409639495
104177,2067,13,0,13,S,29.3647784867666
56857,2068,4,2,6,J,29.012449454392705
159647,2068,3,0,3,N,29.19116884676681
29711,2068,3,3,6,A,28.73678488779804
117201,2067,3,3,6,K,29.06978657854426
161376,2067,6,0,6,K,29.161449828009797
156422,2068,7,2,9,N,28.727669355868287
183392,2068,6,1,7,M,29.23846631452831
93210,2067,4,2,6,J,28.968369761068967
59391,2068,2,1,3,E,28.897699560793363
182859,2067,6,2,8,S,28.85434175256138
145837,2067,6,2,8,M,29.411717355822653
159773,2068,3,2,5,E,29.337144535073858
18210,2068,6,2,8,H,28.822800446902605
103611,2067,1,3,4,P,29.41779808883956
77871,2068,13,0,13,D,28.83195105081085
62901,2068,4,1,5,Q,29.038458193627427
66312,2067,4,2,6,E,29.182881587631645
122887,2067,2,0,2,P,29.592932873530906
101150,2068,3,2,5,N,29.0102291846319
29489,2067,2,0,2,E,29.14719402993422
163088,2067,2,0,2,M,29.512701996435137
138235,2067,2,2,4,N,29.43933141935046
66422,2067,5,2,7,K,29.285824226523907
41461,2067,3,0,3,M,28.94936374595344
83669,2067,3,1,4,E,29.13737599385173
110851,2068,6,1,7,P,28.92494947933365
19653,2068,4,0,4,D,28.97114642614242
42092,2068,6,0,6,E,28.953252093942066
59890,2068,5,2,7,J,28.91951168400233
72726,2067,2,1,3,P,29.265821981707145
88897,2068,2,3,5,N,29.038334480194205
27296,2067,5,2,7,M,29.313052914943157
107330,2067,5,2,7,J,29.374772554587903
162498,2067,6,2,8,M,29.12480724299552
147219,2068,4,2,6,M,28.956268065654125
142054,2067,6,2,8,L,29.115042980414213
133833,2067,4,1,5,K,29.08761409639077
111748,2067,6,1,7,E,29.072043143193973
146635,2068,5,0,5,P,29.11261131052804
25690,2068,4,3,7,N,28.746290060394685
175776,2067,7,2,9,L,29.2997159258463
45609,2067,1,2,3,Q,29.087409685786906
73742,2067,4,2,6,M,29.06103239346976
132755,2068,13,0,13,E,29.2048257549742
30872,2067,6,2,8,E,29.25447873205985
62437,2068,3,1,4,E,29.086336782241062
176970,2068,7,2,9,E,28.79305411468881
133648,2068,3,3,6,N,28.71755081623138
128874,2068,5,3,8,N,28.92459375889145
108270,2068,6,2,8,N,29.23477267569902
19007,2067,6,0,6,S,29.09081636738006
17587,2067,4,3,7,N,29.37625753026079
96814,2067,7,3,10,A,29.11389320597311
148132,2068,6,3,9,M,28.97236511902835
135085,2067,2,0,2,N,29.05621036931338
162081,2068,1,3,4,J,28.797190091864497
91799,2068,5,1,6,N,29.09605261692981
167798,2068,3,0,3,Q,28.798956145762432
29285,2067,4,2,6,P,29.171172675047785
130779,2068,6,1,7,F,29.014708066445788
78527,2067,6,0,6,P,29.203469895083824
159643,2068,2,1,3,J,28.95917116936323
73450,2067,2,3,5,K,29.39314106101492
79026,2068,4,1,5,M,28.846726217915045
36354,2068,2,2,4,D,28.78509593062376
116963,2068,5,0,5,E,28.835450297683515
61911,2067,5,0,5,M,29.34983942580601
146051,2067,3,1,4,K,29.14381851063267
57272,2068,9,1,10,M,29.28256358685723
110345,2068,4,0,4,N,28.981617286728014
76437,2068,6,1,7,J,28.944330637488825
138264,2068,8,2,10,P,28.87736550495944
70180,2068,5,2,7,H,28.878273816488345
133801,2068,3,2,5,J,28.556666226772435
19132,2067,6,1,7,E,28.91920899726985
67674,2067,2,2,4,N,29.192509990029496
59180,2068,2,1,3,D,28.625230719466277
138208,2067,7,1,8,N,29.13264355269576
32908,2067,3,4,7,E,29.323940537045257
81748,2067,2,4,6,K,29.005673901320733
143467,2067,6,0,6,E,29.144703888112414
157326,2067,4,1,5,J,28.82825760736827
97177,2067,4,0,4,D,29.54730300230148
20296,2068,2,1,3,J,29.44750515281041
19950,2068,1,2,3,D,28.589752004867403
160800,2067,5,2,7,E,29.07954246791923
53392,2067,3,4,7,E,29.18409310416904
77783,2068,3,1,4,P,28.75664698418849
73057,2068,3,0,3,P,28.87810316835893
129007,2068,5,1,6,Q,28.86633461971547
103569,2067,3,1,4,E,29.1012556715173
20005,2067,2,1,3,E,28.928855867250583
159418,2067,2,2,4,J,29.44592069957016
111211,2068,1,1,2,S,28.816833940317714
162098,2067,7,1,8,J,29.088875886452296
137931,2067,3,1,4,M,29.32091575827451
111626,2068,4,1,5,M,28.977958497571517
24670,2068,4,2,6,A,28.75989582744817
100785,2068,4,3,7,J,28.94061542363246
87970,2068,5,1,6,P,28.776781023872942
156036,2068,4,2,6,N,28.900114119037703
115944,2067,4,2,6,E,29.128904004917217
122912,2068,6,1,7,E,28.993068164592785
116774,2068,6,0,6,Q,28.921942415425463
34874,2067,2,3,5,C,29.07517914014688
158759,2067,4,0,4,N,29.322550177575977
21790,2068,5,2,7,E,28.724717753569838
160555,2068,3,1,4,N,28.752658908728502
71183,2068,6,1,7,J,28.70561331634313
150166,2068,5,1,6,N,28.81640005062064
140690,2067,6,2,8,M,29.36917549652758
109825,2067,2,2,4,P,29.34668125526813
178349,2067,3,0,3,P,29.09725632977208
149606,2068,6,1,7,K,28.92496540122767
176872,2067,6,3,9,L,29.20283640803292
163273,2067,4,2,6,P,29.31903791461924
103083,2068,1,3,4,K,28.95408888334316
97486,2068,11,4,15,A,28.73731062250212
24028,2068,5,2,7,J,28.612206618550648
138458,2067,3,3,6,E,29.28884091534401
62126,2068,6,1,7,E,28.92417157144962
174689,2068,6,0,6,N,29.30063142676096
141199,2068,3,2,5,P,29.043907868382288
141312,2067,4,2,6,M,29.291573895464616
164316,2067,5,3,8,Q,29.034422921068124
78654,2068,6,1,7,P,28.92768456609661
161459,2068,9,3,12,I,28.9469503438482
107651,2068,9,1,10,N,29.149378847071244
59492,2067,13,2,15,Q,29.02098442529965
52536,2068,4,2,6,P,28.927550373071966
102938,2068,4,2,6,N,28.97106378304968
70685,2067,3,2,5,J,29.223647166985227
181929,2068,7,2,9,Q,29.012299018403503
88655,2068,6,1,7,K,28.944011748147844
173253,2068,2,4,6,D,29.07990919746716
136820,2068,3,0,3,M,28.86051235155217
2585189,2067,3,2,5,E,29.046008830059087
66817,2068,2,0,2,Q,29.100350315772232
145425,2067,1,2,3,M,29.36084753943613
123600,2067,4,2,6,M,29.519806281226703
62729,2067,4,2,6,Q,28.744407426295467
53595,2067,6,0,6,A,28.87837287498889
32433,2068,6,1,7,N,28.788916183747485
109714,2068,5,2,7,K,28.837207981554517
135848,2067,3,3,6,M,29.32183841737698
41464,2067,6,1,7,M,29.045238251760622
108760,2068,7,3,10,F,28.51236101689465
77909,2067,3,1,4,Q,29.28170616886495
128280,2067,2,1,3,M,29.40888618763984
127761,2068,3,0,3,P,29.048701129067812
31819,2067,5,2,7,N,29.12945501595258
46121,2068,3,1,4,J,29.046476991511952
137102,2068,2,2,4,P,28.97812399138933
112657,2068,5,5,10,E,28.92558749420922
143679,2067,3,2,5,K,29.34543112733749
110037,2068,7,2,9,K,29.10669880151246
83109,2067,5,2,7,A,29.43292667826328
178787,2068,3,2,5,E,28.70753363660242
98666,2068,2,1,3,N,29.01322527638484
147527,2067,6,1,7,P,29.12940767808195
105109,2068,4,2,6,M,29.123033094925628
21104,2067,4,3,7,Q,29.01369631652177
72761,2068,7,0,7,E,28.799354866885334
27776,2067,7,2,9,D,29.286663912913752
34038,2068,10,2,12,E,28.69676051982268
52490,2067,5,3,8,A,29.21516532106589
114070,2067,3,1,4,E,29.637162683793417
159140,2068,2,3,5,E,28.583893731404327
60429,2067,2,2,4,I,29.065454165590893
54318,2068,4,0,4,E,28.558991230464237
89714,2067,5,2,7,Q,29.154844155712027
59492,2068,11,4,15,Q,28.657594955885315
124005,2068,6,2,8,J,28.98732367395469
83630,2068,2,2,4,A,28.89398446784313
110556,2067,1,2,3,N,28.82623951420893
33676,2067,2,3,5,J,29.31035442079977
60436,2068,1,1,2,N,29.080665042467068
22765,2068,4,2,6,M,28.849671019521978
92110,2068,5,2,7,D,28.514619968936632
37094,2068,7,2,9,S,28.67833277102608
27858,2067,6,2,8,Q,29.303906784102598
33282,2068,5,2,7,E,28.51202347228049
48565,2067,4,1,5,N,28.96394089181202
65241,2067,5,2,7,J,28.985533115743912
37580,2068,6,3,9,F,29.091782230800828
98819,2068,9,2,11,E,28.97940934156596
91741,2068,3,1,4,N,29.172441507615883
29347,2068,6,1,7,I,29.00204686020931
65639,2067,4,0,4,P,29.58054216453571
170216,2067,8,2,10,D,29.262965637443667
133502,2067,2,2,4,E,29.267518743836284
79313,2068,2,1,3,Q,28.8883222869746
132424,2067,5,3,8,M,29.106020426499978
110552,2067,1,1,2,J,29.12640554866546
166947,2068,4,2,6,D,28.835897038911742
78677,2068,7,0,7,E,28.56878750562012
32511,2068,6,2,8,Q,28.53918959181592
129411,2068,3,2,5,M,28.685462955688195
114308,2067,8,3,11,M,29.21528971335743
48287,2068,7,0,7,E,28.96097761793636
92927,2067,4,2,6,P,28.948305855544564
115492,2068,6,1,7,M,28.60173983259672
74861,2067,5,1,6,Q,28.732987425256013
57093,2068,3,2,5,S,28.94508803983101
47866,2067,3,2,5,N,28.97659126881813
128040,2067,1,3,4,K,29.242762700571923
38931,2068,5,2,7,C,28.67737294482536
136103,2067,5,2,7,J,29.202044361170067
95513,2068,1,3,4,A,28.78200231180335
15858,2068,4,2,6,Q,28.98788658708899
158642,2067,7,2,9,N,29.41551954369647
136761,2067,2,0,2,P,29.05800602677032
106744,2068,2,1,3,S,29.26594307415579
136609,2068,2,1,3,I,28.72856518106042
81482,2067,5,0,5,D,29.414892018479
84411,2067,8,2,10,A,28.975552615439607
32184,2068,6,0,6,D,28.932683953946643
63181,2068,5,0,5,Q,28.87850742102302
95994,2068,4,1,5,P,28.85867126926919
132367,2068,6,1,7,N,29.0140443826981
180022,2068,8,2,10,J,28.585393393708944
131473,2068,7,0,7,J,28.809934271110464
146323,2068,5,2,7,M,28.610126948321785
41088,2067,3,1,4,Q,29.21212980261872
180527,2068,4,2,6,P,28.95158193201581
98161,2067,4,0,4,M,29.02419622720892
145768,2067,6,1,7,M,29.26819759118872
53710,2068,6,1,7,Q,28.832781374411496
52326,2068,3,2,5,E,28.85894206488583
55341,2068,4,0,4,P,28.82756746733871
132289,2067,2,1,3,J,29.49288440634169
113745,2068,4,2,6,Q,28.925489604824477
180135,2068,6,2,8,P,28.871175359993245
165465,2068,7,2,9,P,28.82867442251719
169955,2068,6,1,7,N,28.77107886494224
28797,2067,5,2,7,K,29.086283709596294
95166,2068,5,2,7,M,28.90261776763514
114867,2068,2,0,2,J,28.90048744112706
146069,2068,6,1,7,M,28.936553226324317
111471,2067,4,2,6,J,29.56529905046889
63021,2067,4,1,5,D,29.340859040961597
147012,2068,6,1,7,M,28.964335590719685
77894,2068,4,1,5,E,28.7087498966316
98952,2068,3,1,4,K,28.816038022416222
180468,2067,5,1,6,A,29.214417202485134
150428,2068,5,1,6,M,28.976288493012877
53138,2068,3,0,3,D,29.23090616721445
97855,2068,3,2,5,N,28.431757126389115
76121,2068,9,1,10,P,28.972041827796907
160656,2068,4,0,4,N,29.19836164268005
130057,2067,3,2,5,P,28.97074491687228
135245,2067,6,2,8,M,29.323587613080612
177030,2068,6,3,9,M,28.664738820643706
167060,2067,2,1,3,P,29.266207317864115
167626,2067,4,2,6,N,28.960229497306592
180908,2068,1,4,5,I,28.843753978878077
82015,2067,6,2,8,E,28.716442756148247
49340,2067,4,2,6,A,28.91892095642252
72974,2068,6,0,6,E,28.727979375116693
92344,2067,4,1,5,Q,29.21793797314056
136178,2068,2,1,3,Q,29.13442925925536
178232,2068,4,1,5,D,28.5971929185805
171170,2067,4,0,4,A,29.489019872260744
77126,2067,7,2,9,E,29.51311306888737
66607,2068,5,3,8,D,28.897076042708523
129515,2067,10,3,13,L,29.09761833231659
179580,2068,4,3,7,M,28.661757764920942
64831,2067,6,0,6,P,29.401569994421337
94940,2068,4,2,6,Q,29.099364265099418
104622,2068,5,1,6,Q,28.491501857565364
63336,2068,10,4,14,J,28.497166513261774
145511,2067,3,3,6,M,29.3673018888924
105607,2068,6,0,6,J,28.820377801564508
69463,2067,2,2,4,N,28.943919181810084
157183,2067,2,2,4,J,29.75265634027925
136765,2067,6,1,7,H,29.281213896992583
147002,2067,4,1,5,M,29.31543540567868
166000,2067,2,2,4,S,28.99142109565853
143589,2068,2,3,5,P,29.074692517310275
25556,2067,3,3,6,D,29.26810441842297
146798,2068,3,3,6,N,28.68166550496157
162787,2067,2,2,4,E,29.67346188344163
170410,2068,2,2,4,Q,29.14503686559776
59448,2067,6,1,7,J,29.182848592501845
102594,2068,9,3,12,P,29.050675218159217
26172,2067,9,1,10,H,29.17623375719129
20652,2067,7,1,8,N,28.81165589165697
41130,2068,5,2,7,N,28.906959923533623
30641,2067,5,2,7,E,28.918373584567647
129235,2067,3,2,5,P,28.985934433902035
115721,2067,5,1,6,P,29.0521579446384
147841,2067,3,2,5,M,29.290935503648186
109299,2067,4,1,5,J,29.584910510303583
145513,2067,7,2,9,M,29.4155144593128
30917,2067,4,7,11,F,29.2999620448064
82360,2067,15,2,17,A,29.344908818030767
66809,2067,2,0,2,Q,29.314558835304805
160006,2068,5,2,7,E,28.595511695451496
92300,2068,6,1,7,E,28.85307172194473
140279,2068,4,1,5,I,28.782538893035856
141592,2068,6,1,7,D,28.75522244220189
110891,2067,9,3,12,E,29.20001599961447
104602,2068,3,1,4,E,28.824263073510448
136460,2068,2,1,3,P,28.984884706631476
106894,2067,7,4,11,E,28.64425310273073
143210,2067,4,0,4,E,28.93771397767292
162278,2067,4,0,4,E,29.479438186342463
167407,2067,4,1,5,N,29.060064199586705
119434,2067,5,0,5,E,28.964052015128186
89575,2068,3,1,4,M,28.61700002027455
103927,2068,1,3,4,E,29.134167823014188
87593,2067,5,1,6,D,29.195980613480383
118247,2068,3,1,4,E,29.08751035410799
41076,2068,2,3,5,A,28.960422786811503
145091,2068,6,0,6,C,28.782609345224625
166968,2067,5,4,9,S,29.240177655811543
16004,2068,6,1,7,D,28.831812812033736
88172,2068,3,1,4,M,28.742147759235326
71331,2068,10,2,12,N,28.78888463060957
47602,2067,11,1,12,D,29.15770125480226
44480,2068,5,1,6,N,29.0640909295089
25516,2067,6,2,8,N,29.199986981668665
113866,2067,1,3,4,J,29.04674053705501
97470,2068,4,0,4,Q,28.767087044556725
101403,2067,14,2,16,D,29.328921046259712
32004,2068,6,2,8,H,28.87376174166005
30867,2067,5,2,7,N,29.588959168479697
176825,2067,4,1,5,N,29.318344013585225
143995,2067,7,0,7,M,29.264395533113237
180765,2068,12,3,15,D,28.37835223124312
133757,2067,3,1,4,K,29.209017846383343
90256,2067,3,2,5,J,28.92924976866564
167010,2067,3,2,5,Q,29.433348181192702
66261,2067,10,0,10,P,29.26944918479882
138998,2068,8,2,10,E,28.456042784370464
128283,2068,4,0,4,E,28.8252483606608
164613,2068,6,3,9,S,28.81539978466528
110708,2068,4,2,6,J,28.56586758759611
156292,2067,9,4,13,N,29.00076057040087
170629,2067,6,2,8,P,28.913076039736467
147765,2067,6,1,7,M,29.22589145477532
67215,2067,3,1,4,N,29.091884118285503
141875,2068,9,4,13,P,28.99132259885699
19920,2068,2,1,3,S,28.95015084397631
78486,2068,3,0,3,K,28.635593718769936
96173,2067,6,2,8,D,28.900176478532124
83760,2068,4,0,4,K,28.91642446327407
98355,2067,1,1,2,M,29.11720046551587
107445,2068,6,3,9,J,29.10473307158764
175463,2068,4,0,4,A,29.09201489306697
46538,2068,4,1,5,N,28.520122067150908
45322,2068,2,0,2,Q,28.84414086241292
90679,2068,5,2,7,M,28.571884626146858
113606,2068,3,2,5,N,28.918068537766118
108059,2067,11,0,11,E,28.995638578381342
137671,2068,5,3,8,N,28.841357765179144
76663,2068,2,3,5,E,28.868560851886663
55487,2067,6,2,8,J,29.090700165839124
144967,2068,5,1,6,N,28.83562879298809
27729,2067,6,0,6,D,29.088990834320803
71679,2068,3,0,3,P,28.639349805173115
24899,2067,5,3,8,E,29.34180519058611
178982,2067,3,3,6,J,29.41298054507268
73808,2067,5,1,6,J,29.2275836424457
116344,2068,2,4,6,E,28.767490608325875
165723,2068,2,5,7,J,29.230410478264
96833,2068,2,2,4,Q,29.07067113226437
109901,2067,2,2,4,J,28.95745826658972
77656,2068,4,1,5,J,28.723896267002967
90278,2067,6,1,7,M,29.609026361473585
41793,2068,5,3,8,M,28.849554078713297
98161,2068,4,0,4,M,28.923748552914788
22394,2067,6,0,6,M,29.063220340868323
19046,2067,3,1,4,D,29.130676309064835
109396,2067,15,4,19,C,29.467018715049058
139581,2067,2,1,3,M,28.9115367172288
133056,2068,3,1,4,P,29.02889352842662
172969,2068,8,2,10,A,29.03548309779965
166047,2068,6,2,8,S,28.91057026437347
75378,2068,6,1,7,J,28.71852649649255
179663,2068,3,2,5,J,28.72534313383771
114820,2067,5,3,8,Q,29.34615226564205
94342,2068,1,3,4,N,28.78669396944493
57360,2068,4,2,6,S,29.19794472451477
99699,2068,5,2,7,F,28.833220236385127
117556,2068,10,1,11,D,28.575482558005447
138538,2068,5,3,8,Q,28.86839985141781
24881,2068,3,0,3,E,28.93072000250562
179853,2068,6,2,8,C,29.211232287352697
58882,2067,1,1,2,D,28.84465654363072
98420,2068,2,2,4,N,28.464183636784977
117213,2068,3,0,3,E,28.874151239832425
99001,2067,5,2,7,E,29.45295630315078
143276,2068,4,2,6,N,28.851463095112557
175011,2068,6,1,7,N,28.801011655234504
110698,2067,6,1,7,J,29.44387750046413
24483,2068,5,0,5,J,29.099098317964916
93257,2068,3,3,6,J,28.71565773932617
16757,2068,8,2,10,A,28.989933160039435
51543,2067,5,2,7,E,28.887396909387068
106797,2068,4,0,4,N,28.52669182922876
23413,2067,6,2,8,D,29.016131853883643
64559,2067,4,2,6,E,29.405237965687792
156699,2067,7,2,9,N,29.13836178063077
178489,2067,4,2,6,P,29.48299445139356
39200,2068,8,0,8,N,28.872679112720277
24822,2067,1,2,3,J,29.139883576560123
142917,2068,6,3,9,M,29.0907991751411
148980,2068,5,3,8,M,29.03349694339715
167094,2068,3,1,4,K,28.8333655731556
58922,2068,6,0,6,J,29.333054308754363
129503,2067,4,1,5,M,29.401422923151493
104413,2067,3,4,7,N,29.269105583373136
62418,2067,4,0,4,E,28.933456701322367
74585,2068,3,2,5,Q,28.77558331151437
15728,2067,8,1,9,D,29.202185078817163
105123,2067,2,1,3,E,29.221928547599383
19424,2068,3,2,5,P,28.72606341919004
30505,2067,10,2,12,E,29.493052269298133
179393,2067,6,2,8,D,29.143763583491864
45644,2067,5,2,7,J,29.06830083195082
135317,2068,4,0,4,E,28.52984838536102
145175,2067,4,3,7,M,29.027605535354645
132677,2068,5,2,7,J,28.529788509618385
122040,2067,3,3,6,J,29.308124114466843
62516,2068,4,1,5,Q,28.791205124648965
169506,2068,1,1,2,J,28.80423097555888
41164,2068,5,2,7,E,28.89075264283672
39449,2067,5,1,6,P,29.39178620457871
81341,2068,11,1,12,C,28.6415671061233
79519,2068,6,1,7,P,28.72909815080682
127244,2067,7,3,10,Q,29.16718377830483
22400,2067,3,1,4,M,29.418210835577952
64910,2068,1,4,5,E,28.74416603187967
140967,2067,6,1,7,M,29.176632507972386
109535,2068,3,0,3,E,29.03736501604081
112898,2067,4,2,6,I,29.1420979599
157284,2068,2,0,2,N,28.8036510405628
87793,2068,7,1,8,C,28.93353384311552
119628,2067,4,0,4,K,29.122599095028686
99731,2067,16,4,20,E,29.657686538635403
51918,2068,8,1,9,E,29.012240740415027
144269,2068,5,2,7,D,29.104395579577883
170439,2067,2,3,5,J,28.99831818069775
172551,2068,6,2,8,N,28.826742461705724
44892,2067,6,2,8,M,28.99471854722556
48823,2067,6,1,7,J,29.154750683967123
21012,2068,4,0,4,D,28.57050645603611
111901,2068,1,3,4,M,29.12941379044015
79003,2068,3,0,3,M,28.7700095604907
161204,2068,3,1,4,E,29.21405631912881
53787,2068,4,0,4,S,29.018050297486504
38514,2068,7,1,8,K,28.718709559227865
44969,2067,16,1,17,A,29.17495990230377
158664,2067,2,1,3,E,29.05412812156775
123707,2067,3,2,5,K,29.05187748949923
146368,2067,3,1,4,H,29.1543944443681
129505,2068,6,3,9,J,29.01038461557184
84646,2068,6,3,9,N,29.18369517340503
25599,2067,3,2,5,M,29.393718737581985
171740,2067,3,2,5,Q,29.207640792144915
24434,2068,2,2,4,K,28.9493390037662
48833,2068,6,2,8,M,28.916952501348224
94395,2068,2,3,5,Q,28.92514132862131
165547,2067,5,1,6,P,29.601041765925828
161284,2067,3,2,5,P,29.47221016933648
44660,2067,3,1,4,E,29.2257024380771
73044,2068,2,2,4,E,28.83852046995324
102704,2068,2,2,4,J,28.943838685903515
118836,2068,1,3,4,N,28.80083346994894
106573,2067,3,2,5,N,28.95736459588464
64279,2068,4,0,4,P,29.22273892128737
156294,2067,4,0,4,E,28.908201873995026
144110,2068,2,2,4,Q,28.97656082781524
16095,2067,2,2,4,D,29.0388285810428
112754,2067,5,3,8,E,29.283001319451923
116788,2068,6,1,7,M,28.865555759440785
146307,2067,3,1,4,E,28.931079587858363
42020,2067,6,2,8,P,29.031218430295727
121131,2067,4,1,5,E,29.097343755443667
159037,2068,3,0,3,S,28.94226468940035
40800,2067,1,2,3,J,29.00114782879787
162578,2067,4,1,5,N,29.324457067341267
98588,2067,4,1,5,J,29.3223977618964
106262,2068,4,1,5,K,28.50161216167696
176617,2068,3,2,5,D,28.82229528100321
55194,2068,3,0,3,M,28.87098768427798
121941,2068,6,0,6,E,28.82893965495544
148810,2068,6,2,8,M,28.674939514722197
88818,2067,4,0,4,A,29.02117592240307
162721,2068,8,3,11,M,29.018308231443264
64836,2068,6,1,7,N,28.93033886274483
49802,2067,6,1,7,E,29.53435498524555
71807,2067,2,2,4,D,28.854408152377765
26338,2068,3,2,5,E,28.570918467600155
34550,2067,5,2,7,Q,29.283224886433064
151370,2068,5,2,7,M,28.93073972655303
51667,2068,3,3,6,E,29.34981836581849
44871,2068,4,2,6,D,29.143861893628877
118140,2068,5,0,5,E,28.764221433519985
120988,2068,6,3,9,E,28.773485519344845
159094,2068,6,0,6,M,28.98795916362271
48952,2068,3,1,4,A,28.752921151218622
105989,2068,6,1,7,J,29.028085759833573
120306,2068,4,2,6,E,28.72433067061136
72305,2067,3,4,7,N,29.51384047449927
32855,2068,3,2,5,E,28.5691754859158
100806,2067,5,2,7,Q,28.950995062062525
74939,2067,3,2,5,Q,29.39055935372081
132922,2068,5,2,7,E,28.898967910942154
117576,2068,3,0,3,K,28.698590497642773
104124,2068,4,2,6,E,28.887784440915954
86665,2067,10,1,11,E,28.889253410689182
69962,2067,5,2,7,P,29.213503918128552
145917,2067,4,0,4,P,29.33451008164116
68487,2067,3,1,4,N,29.226094535191304
77640,2067,2,1,3,N,29.350416181009344
16991,2068,3,2,5,D,28.661968270992
97638,2068,7,2,9,N,28.71361687661203
151224,2068,5,0,5,S,29.116131180951363
172811,2068,3,3,6,E,28.650627770657856
160849,2067,10,3,13,M,29.579594148260565
162358,2068,4,2,6,K,28.90230861647097
151494,2068,5,3,8,E,28.641599267040057
164874,2067,6,1,7,D,29.32656421742449
161614,2067,5,2,7,P,29.20978187737296
119955,2067,7,1,8,E,29.039944835384
85599,2068,5,0,5,D,28.73292359547481
40782,2068,7,1,8,N,28.701207017503297
155888,2068,3,2,5,E,28.88985678677781
45380,2068,6,1,7,E,29.043963545995627
76031,2067,2,2,4,J,29.33954231634941
78717,2068,7,1,8,M,28.907732050033697
114467,2067,10,1,11,E,28.96081149895422
46277,2067,6,0,6,P,28.63186281513013
144871,2067,5,2,7,A,29.33149120359979
165932,2067,6,1,7,M,29.403739353653965
78323,2068,5,0,5,K,29.03254115794167
132005,2067,3,1,4,A,29.350466367644284
76485,2067,6,1,7,K,29.280199266703217
95513,2067,3,3,6,A,29.26619724707889
38772,2068,6,0,6,E,28.75873619827179
39164,2068,1,3,4,P,28.784120994294035
20039,2067,5,3,8,E,29.201357331481603
37225,2067,5,1,6,D,29.24018897138116
69378,2067,2,2,4,K,29.16891703532465
40042,2067,2,0,2,E,29.25246465047384
113635,2067,7,3,10,K,29.17460348106944
140851,2067,5,1,6,M,29.3655776138976
163302,2067,6,1,7,P,29.328791127366003
32766,2068,6,1,7,N,28.80173736652919
59111,2067,4,1,5,P,29.37360513676181
170092,2067,3,1,4,Q,29.19730532536386
96764,2067,4,2,6,J,29.12761195404404
123785,2068,2,3,5,J,28.72271750437531
73568,2068,4,1,5,N,29.079635808521594
132210,2067,2,1,3,E,29.15127778571448
174249,2068,3,2,5,J,29.15084757847018
110533,2067,5,1,6,E,29.13227238722248
113266,2067,6,0,6,E,29.174962300281543
143062,2068,3,1,4,M,28.768233326026497
20652,2068,7,2,9,N,29.01239929458006
97280,2068,1,1,2,E,28.819378182904558
129280,2067,3,2,5,K,29.01938097481826
139864,2068,6,2,8,M,29.00833900472246
53024,2068,4,1,5,N,28.77618057854292
52669,2068,4,2,6,K,28.844854438977052
39922,2068,8,2,10,J,28.98643300205444
63349,2068,6,2,8,D,28.599301216387907
55139,2067,3,0,3,N,29.393232265841405
18404,2068,6,0,6,N,29.05401290013446
92912,2068,8,2,10,N,29.059094371320185
160617,2068,3,1,4,P,28.713223759068605
58984,2067,1,1,2,Q,28.983733124642427
60851,2068,4,0,4,N,28.921581768222065
93852,2068,8,1,9,K,28.70996412737512
131557,2067,3,2,5,E,28.98747901743741
57540,2068,7,1,8,M,28.71780000422021
32168,2067,5,0,5,E,28.80594635848192
19882,2068,6,2,8,E,28.819320515210983
47462,2067,2,3,5,S,29.16098319887833
96556,2068,5,1,6,N,28.631639290619336
19668,2068,2,2,4,N,29.08661378902826
158527,2068,5,2,7,Q,28.64285544649413
113488,2068,5,2,7,M,29.0277510275718
33052,2068,7,2,9,E,28.735135732365023
110713,2068,3,1,4,J,28.731988698721917
157239,2067,12,4,16,H,29.307687075779366
83815,2068,9,2,11,N,28.50234071076363
157261,2067,5,2,7,J,29.041203568158245
161388,2068,1,1,2,Q,28.68244261041504
46233,2068,5,0,5,E,28.80623051941827
137311,2068,6,2,8,P,28.95503282399285
60988,2068,2,1,3,P,28.9564264913539
71700,2068,2,1,3,M,28.874730914341853
74223,2068,3,2,5,P,29.04631526526314
77399,2067,4,1,5,D,29.039318793954447
59011,2068,7,0,7,N,28.763334333793527
99611,2067,5,2,7,K,29.103779787116988
149092,2068,2,2,4,M,28.881865633015288
82536,2068,3,1,4,S,28.824069931283116
156015,2067,8,3,11,E,28.81626646735184
74848,2068,7,1,8,N,28.65699891194591
111418,2068,5,2,7,J,28.66277803024049
169746,2067,2,1,3,Q,29.383885043105806
108357,2068,3,1,4,K,28.771519834115622
81705,2067,7,0,7,N,28.952407327781632
19534,2068,7,1,8,I,28.844940583888
149395,2068,6,1,7,M,28.80762127294065
106717,2068,7,1,8,E,29.20592267130991
106862,2068,3,1,4,K,28.57529434425517
75035,2068,5,2,7,N,28.82484009097989
81658,2067,11,2,13,N,29.41369527626488
118527,2067,6,0,6,P,29.58628227778805
88227,2068,6,2,8,J,28.85809636739864
174192,2068,2,3,5,N,29.00989626301591
65566,2068,8,0,8,K,28.53064803809584
38269,2067,3,0,3,E,29.38993267411893
86979,2068,5,0,5,C,28.74729730921769
55940,2068,2,4,6,S,28.66175921518844
133018,2068,5,3,8,E,29.169398650843856
92057,2067,4,1,5,E,29.17281920421476
163913,2067,3,2,5,M,29.306991066913188
48217,2068,1,3,4,S,29.0996258664164
88674,2068,7,1,8,F,28.890043421907027
182867,2067,2,3,5,M,29.09728245612181
31215,2067,3,1,4,K,29.50269376133958
86776,2067,4,2,6,K,28.84545962359197
117725,2068,6,0,6,P,28.748987640361356
37306,2068,7,1,8,H,28.876108894501517
128040,2068,4,3,7,K,28.9154399421416
171046,2067,17,3,20,N,29.153510061331712
39323,2068,6,0,6,Q,28.593665447821294
106119,2067,5,0,5,P,29.451295742209364
164429,2067,5,2,7,K,28.89658370210537
179093,2067,10,1,11,E,29.11011026951018
41227,2068,4,4,8,D,28.590815955773987
98760,2068,5,0,5,N,29.20134287358357
109777,2068,4,2,6,J,28.77287809960508
168051,2068,2,1,3,M,28.77952459412216
97717,2068,3,2,5,N,28.63918968510565
108418,2068,2,1,3,E,28.673144342035616
146909,2067,3,2,5,F,29.133385227670683
44566,2068,6,3,9,E,28.86431218172552
109427,2068,5,0,5,P,28.650502246301247
94139,2068,7,2,9,M,28.99598803543032
67469,2067,5,1,6,P,29.106896140707477
129885,2068,3,1,4,N,28.81622202910728
129183,2067,5,2,7,N,29.13776728488149
23490,2068,4,0,4,E,29.142222497326877
159831,2067,2,1,3,J,29.303153508185723
133646,2068,7,0,7,N,28.88048781812886
39138,2067,5,2,7,J,29.02046742443752
115111,2068,5,2,7,E,28.640746101308583
133281,2068,4,1,5,K,28.90893051927108
36349,2068,3,0,3,S,29.07266085079183
111422,2067,6,1,7,J,29.19284804977261
93340,2067,7,1,8,N,29.220904673706432
141937,2067,3,2,5,P,28.95613974062892
91785,2068,6,0,6,K,28.531349678376166
130458,2067,4,2,6,K,29.474983518631998
117435,2068,3,0,3,J,28.76759666950183
133851,2067,1,1,2,M,29.21416777164604
145975,2068,5,1,6,E,29.04051801484916
76488,2068,6,2,8,L,28.81473007842917
141437,2067,3,2,5,P,29.43093961648855
160679,2067,3,0,3,N,29.20389655042925
59651,2067,6,0,6,R,29.046329055529345
160613,2067,4,1,5,E,29.09739523886783
96631,2068,5,1,6,J,29.064656054105537
134231,2068,5,2,7,K,28.909050266710626
180506,2068,6,0,6,M,28.99541004386362
96465,2067,4,2,6,N,29.139653692658776
110839,2067,5,2,7,M,29.241610766204563
16906,2068,4,2,6,P,28.693053982758123
99404,2067,6,1,7,N,29.09656466045672
145504,2068,5,0,5,P,28.808525656413373
107092,2067,2,3,5,Q,28.93978015009904
147818,2067,6,0,6,M,29.14474438813025
107329,2068,4,1,5,E,28.791518573555035
92934,2067,2,1,3,D,29.2913994974542
146978,2067,4,0,4,M,28.870715095021943
177076,2068,6,2,8,N,29.01768109768174
53304,2067,2,2,4,E,29.33086493944472
103490,2068,5,0,5,D,28.83377462904295
44970,2068,10,2,12,D,28.82288100609065
167070,2068,7,2,9,Q,28.48949844256993
117744,2067,5,1,6,J,29.200468530967324
122000,2067,12,2,14,E,28.96073092738564
180946,2067,0,2,2,E,29.218634333036302
91671,2068,1,2,3,D,28.59215987090601
30381,2067,5,0,5,E,29.17330525959212
182653,2068,6,3,9,M,28.971787289461084
75146,2067,5,0,5,N,29.115434326328035
84283,2068,2,2,4,P,28.71048545357794
106125,2067,3,3,6,E,29.116143352071155
102052,2068,4,2,6,Q,28.933666248702465
109587,2067,6,1,7,Q,29.602764050521795
34060,2068,5,2,7,E,29.025096969815305
122612,2067,6,1,7,M,29.213544680079607
113703,2067,5,1,6,Q,29.40670264404488
140736,2067,6,2,8,E,29.169869602508967
47116,2067,6,2,8,E,28.899857902879432
182704,2067,7,1,8,C,29.59434634738229
46806,2068,6,1,7,K,29.049464317451942
171548,2068,3,2,5,D,28.715039993792796
93601,2067,5,1,6,N,29.357610349040016
118410,2067,2,2,4,E,28.979238032720897
90748,2068,7,0,7,N,29.005523844839438
138755,2068,3,2,5,N,28.899818059110466
39739,2068,7,1,8,M,28.991046864800577
41498,2067,3,2,5,C,29.206835017382865
72462,2067,5,2,7,E,28.879890685114216
78659,2068,6,0,6,M,28.913064816204667
62853,2067,4,1,5,M,28.868782664840147
121982,2068,4,4,8,K,29.304400937883145
142970,2067,2,2,4,M,29.08800087242439
94532,2067,6,2,8,N,29.06669891055572
21989,2067,4,0,4,M,29.283260935538788
109897,2067,6,0,6,M,29.172466254147004
182187,2067,4,5,9,I,29.31244896442449
146054,2068,6,0,6,M,28.9381407482859
107805,2067,2,1,3,K,29.133101024558183
70021,2068,13,3,16,P,28.77126993302741
181514,2067,5,2,7,K,29.30806369852332
147436,2067,2,1,3,N,29.28663723193642
113829,2067,6,1,7,Q,29.02869882049078
27699,2067,5,2,7,P,29.16883660038492
149625,2068,6,3,9,A,29.01201198646084
81858,2068,6,0,6,N,28.75411806587081
176950,2067,6,1,7,E,29.248193518625488
148434,2068,2,2,4,M,28.984851771428275
60106,2067,3,1,4,D,29.296502659916065
100209,2068,3,2,5,M,29.30801008547828
74975,2068,2,4,6,K,28.83999617644714
160069,2067,3,1,4,J,28.921035357756818
119379,2067,4,0,4,E,29.61180451668816
39052,2068,4,1,5,Q,28.808718304982087
34407,2068,4,1,5,E,28.464862846998653
26865,2067,4,0,4,D,29.31723953505671
18127,2067,5,1,6,P,29.212072340166355
86368,2068,4,1,5,J,28.984486527534237
132893,2068,5,0,5,M,28.720022056840087
44842,2068,4,1,5,E,28.44689808194373
137404,2068,5,2,7,M,28.45861821656982
121245,2067,1,3,4,J,29.54487591358481
185035,2067,9,2,11,P,29.167198337609666
16323,2068,2,2,4,P,28.847081983649485
64023,2068,5,1,6,C,28.761464129132843
69608,2067,6,0,6,E,29.15561704760427
182613,2068,11,3,14,E,28.616520289210456
69881,2067,10,3,13,E,29.196356991877867
61694,2068,2,0,2,N,28.79134676036358
135112,2067,1,1,2,J,29.08044914316467
21417,2067,0,4,4,J,29.037027847307968
48700,2068,5,1,6,P,28.71254585583868
16813,2068,4,3,7,N,28.90398043832384
76874,2067,7,1,8,Q,29.472353766315894
69884,2067,10,6,16,P,28.960329854546497
175594,2068,3,1,4,N,28.96898988641059
32383,2068,4,3,7,F,28.8574973598832
157835,2068,8,2,10,E,29.24276195540149
185015,2067,10,3,13,P,29.41928314736807
72230,2068,6,2,8,Q,28.93557605626004
169433,2067,3,0,3,D,29.36684168950205
37277,2068,3,3,6,P,29.005658476817217
113618,2068,5,1,6,E,28.748128775575537
50193,2067,5,2,7,N,29.277051867700514
34586,2067,15,2,17,C,29.16594755542937
158762,2067,3,1,4,Q,29.50634968401321
182514,2067,4,2,6,M,29.24188178142963
69650,2068,9,2,11,M,28.9262635868542
92950,2068,4,0,4,D,29.03340723171374
56460,2068,6,1,7,M,28.77942757544426
137038,2067,2,3,5,E,29.19578260260679
178522,2068,1,3,4,N,28.87869167186675
141613,2067,5,4,9,K,29.028974940253963
59416,2068,5,1,6,D,28.842100664773085
134049,2067,4,2,6,P,29.106658353162963
41773,2067,4,1,5,M,28.8043404624769
82546,2067,4,0,4,J,29.19712612269197
120544,2067,6,3,9,E,29.566417960803253
94582,2067,7,3,10,P,29.285715386489983
99989,2068,6,0,6,Q,28.81951368832497
61802,2067,4,0,4,M,29.05851501154527
82868,2068,5,1,6,D,29.099418144527924
176900,2068,3,0,3,E,28.73822510641655
161616,2068,3,0,3,Q,28.623780894326643
167764,2068,4,2,6,E,28.776211058065314
56148,2067,9,2,11,M,29.31390642111621
91932,2067,4,0,4,N,29.21098983212541
167256,2068,5,0,5,M,29.171661319670815
143957,2068,3,2,5,E,29.02395411907988
18690,2067,8,2,10,E,29.2888197649314
135260,2067,4,3,7,N,29.120507161520887
150023,2068,3,4,7,M,28.66583113147205
64933,2068,6,2,8,N,29.02394518267975
17022,2067,7,4,11,E,29.525567147227527
73066,2068,4,1,5,D,28.722513605422645
183413,2068,4,0,4,N,28.809465723761143
172770,2068,2,1,3,D,28.799080970564635
36526,2067,1,1,2,I,29.17471197155426
36890,2068,2,2,4,M,28.81645733575564
19558,2067,4,2,6,K,29.10703965499328
163030,2067,5,2,7,K,29.21716735661092
82851,2068,2,1,3,E,28.58614617530249
108450,2068,6,1,7,K,28.83394723501985
101979,2068,5,0,5,K,28.976787520097545
105292,2067,4,3,7,F,29.509609311078105
47283,2068,4,2,6,D,28.645936762983226
100118,2068,1,2,3,S,28.607425041737518
177248,2068,2,3,5,F,28.902103930384047
39063,2068,1,1,2,E,28.812763700846904
20023,2068,7,1,8,E,28.73987895765597
59139,2067,6,2,8,Q,28.971106845677195
113085,2068,3,4,7,N,29.017150764494705
67447,2068,5,1,6,Q,29.11888916444632
15753,2067,2,0,2,N,29.029181721470525
172875,2068,6,2,8,Q,28.74227628159817
53056,2067,4,1,5,D,29.189893787487577
181719,2067,13,3,16,P,28.984938796158836
91573,2067,10,1,11,N,29.37789589253174
169287,2068,4,1,5,N,28.81798541088436
114537,2068,3,0,3,E,29.06623047712546
93508,2068,3,0,3,Q,28.963650935347932
76547,2067,7,1,8,K,29.00477698649417
69955,2068,5,2,7,N,28.7201808509878
50879,2068,5,0,5,E,28.72707752366721
110583,2068,3,1,4,E,28.527001834372022
44866,2068,7,0,7,Q,28.90969046610013
106717,2067,3,0,3,E,29.094402547128887
144343,2068,8,3,11,M,28.464815982053437
150301,2068,3,0,3,P,28.834068510489143
113057,2067,3,0,3,J,29.254906938721223
164367,2068,2,2,4,C,28.433597265081765
94366,2068,4,2,6,P,28.801694691907155
122253,2068,6,1,7,E,29.048072843893657
22912,2068,6,0,6,N,28.84250895777189
117192,2068,9,5,14,A,28.86821489967265
76534,2068,4,2,6,K,28.817501259838096
137821,2068,8,4,12,I,28.656873075794053
114141,2068,5,2,7,N,28.468864453804613
147159,2068,6,2,8,M,28.92635938194778
82249,2067,7,2,9,N,29.140923818795084
144541,2067,6,1,7,Q,29.27599950971217
29413,2068,3,0,3,E,29.137804916491884
115820,2068,3,1,4,E,29.04455288285769
39942,2068,5,1,6,M,28.632202098548465
41659,2067,3,3,6,J,29.15872753180592
62261,2067,5,1,6,D,29.24187707193068
18373,2068,3,2,5,A,28.67394483993256
101990,2068,6,2,8,J,28.79607751020765
75214,2067,2,2,4,I,28.94742066389952
109749,2068,4,2,6,P,28.793246813246256
78436,2068,5,1,6,S,28.996903115529552
145156,2067,4,2,6,M,29.208346566540605
18730,2067,5,1,6,D,29.04701547837
49266,2067,3,3,6,J,29.124947236205383
44411,2067,2,1,3,N,29.086982670159266
95521,2068,4,2,6,N,28.772327813820223
99982,2068,4,1,5,D,29.137129922034383
101866,2068,3,2,5,E,28.94961381520825
120810,2067,6,2,8,J,29.26023934719993
181375,2068,6,1,7,G,28.85101768815469
132126,2067,2,0,2,E,29.21047368643348
167411,2068,3,2,5,N,28.839760365181967
97551,2067,5,3,8,J,29.302393311037527
97345,2067,6,0,6,E,29.558400158519408
167067,2068,4,2,6,D,28.93171153978685
136722,2068,5,2,7,K,28.74418678417063
144897,2068,6,2,8,Q,28.76656693123184
90122,2068,5,2,7,M,28.84223154744118
182364,2067,7,1,8,K,29.061125494673277
92334,2068,7,0,7,Q,28.994790780375133
164830,2068,2,2,4,M,29.253918307386197
98833,2068,1,3,4,E,29.04020556473852
110872,2067,3,0,3,D,29.129123501009463
18752,2067,4,1,5,H,29.11660325554637
75361,2068,3,0,3,Q,28.800083514011806
40991,2068,6,1,7,S,28.69245715579338
56472,2068,2,1,3,Q,28.83852281728811
105111,2068,7,1,8,D,28.65281625950341
74074,2068,7,2,9,E,28.9772984451899
160696,2067,5,0,5,E,29.06986111526119
67075,2068,7,3,10,D,28.768473292341334
177291,2067,4,1,5,M,29.23195606237443
88979,2068,5,0,5,A,28.92566216444365
49748,2068,9,6,15,I,28.55349737278756
54949,2067,5,0,5,D,29.281655600848577
108682,2067,4,2,6,M,29.405883826504063
76513,2068,7,3,10,I,28.53014914217016
37606,2067,7,1,8,H,29.72609373965773
174224,2067,3,3,6,E,29.101606831861154
133739,2067,3,1,4,N,29.374914789714254
135662,2067,6,3,9,J,29.231539680891878
94536,2067,6,1,7,E,29.2168383456561
112272,2068,9,3,12,P,28.77208331934031
145039,2067,5,1,6,K,28.947282244733906
169917,2067,3,2,5,E,29.087717719780297
127479,2067,7,0,7,Q,29.11943659914967
32366,2067,5,1,6,E,29.26516503828645
182786,2067,4,2,6,E,29.084623232445672
144577,2068,5,2,7,M,28.871372654556907
48266,2067,6,2,8,S,29.164222897078467
166851,2067,6,2,8,Q,29.34462908308925
85509,2067,3,1,4,E,29.41670396720053
83375,2068,4,0,4,F,29.13587199122782
110660,2068,4,1,5,P,28.55864097300732
132286,2067,3,1,4,N,28.885864072692467
100249,2068,5,1,6,N,28.633880267249285
169568,2068,4,2,6,D,29.19005543962752
32244,2067,3,0,3,N,29.14403694701798
54034,2067,4,1,5,H,29.318694423822134
49299,2068,4,3,7,S,29.013494559509105
72156,2067,6,3,9,J,29.20214918427165
123254,2067,1,2,3,P,29.30161022586247
75604,2067,4,0,4,S,29.27424567745818
89728,2068,3,2,5,C,28.80763128576476
159771,2067,4,3,7,S,29.188154884165492
92596,2067,2,2,4,J,29.34915202114438
140783,2068,2,3,5,Q,29.283785503147072
135922,2068,3,3,6,E,28.698832215232954
123926,2067,5,1,6,P,29.17497761789497
78423,2068,7,1,8,M,28.803791641202693
116914,2068,8,3,11,E,28.87832150591865
171219,2068,5,0,5,A,28.680159704654017
107740,2068,4,3,7,J,28.89180908393269
150894,2068,6,1,7,Q,28.866771371363416
65173,2067,4,4,8,E,29.04002840279533
92488,2068,1,3,4,E,28.494615664112168
93608,2067,4,2,6,N,29.389832014156102
148759,2068,3,1,4,M,29.01089326864434
75395,2067,2,3,5,J,29.371348719034103
179023,2067,5,2,7,D,29.11864335697669
61806,2068,6,1,7,N,29.19935304541385
145529,2068,6,1,7,E,28.58884077425823
123384,2068,7,1,8,M,28.850828583259386
173175,2068,25,4,29,C,29.009493160456092
99518,2068,4,2,6,N,28.68582252093123
47904,2068,2,2,4,N,28.922526025719293
115626,2067,5,0,5,N,29.517624212811928
156543,2067,3,1,4,A,29.27279327890238
100407,2067,0,3,3,N,29.089873600366545
121755,2068,2,3,5,Q,29.217508852789877
60240,2068,5,0,5,N,29.06057982664948
53950,2067,3,0,3,K,28.710875574794034
47012,2067,5,0,5,N,29.258012423603883
157483,2068,1,2,3,P,28.755525239744475
141820,2067,4,0,4,Q,29.050534832553637
92934,2068,2,1,3,D,29.07808612920075
128697,2067,2,2,4,M,29.323472308710706
50005,2068,3,3,6,K,28.805477898657895
146549,2068,7,0,7,M,28.57513461181064
38322,2068,6,2,8,E,28.8189672772392
16403,2067,4,1,5,P,29.331140676480008
112546,2067,6,1,7,J,29.192301750634098
99929,2067,2,1,3,K,29.19099176186124
66831,2067,6,0,6,P,29.12712328276781
82177,2068,4,2,6,H,29.109849880346648
108025,2068,5,3,8,M,28.812036135226315
103937,2068,3,0,3,E,28.77867853780987
98610,2067,5,3,8,P,29.04681558615636
172982,2068,6,1,7,E,28.84103144139396
138561,2067,8,1,9,E,29.22964405094321
81288,2068,4,0,4,S,28.693888321668563
105241,2068,5,1,6,M,28.80753636282237
78695,2068,6,1,7,J,28.768714909454044
60015,2068,3,2,5,E,28.640523632476675
45083,2067,6,1,7,J,29.09182089434258
103951,2068,5,2,7,N,29.11511453913348
78758,2068,4,0,4,J,28.696704567222525
84087,2068,5,7,12,I,28.892911622194347
34274,2067,7,0,7,K,29.25676953042422
145853,2067,6,2,8,J,29.268416331674253
90612,2067,4,0,4,Q,29.234795526624005
94018,2068,1,2,3,N,29.09047727544969
34001,2068,2,0,2,P,28.76668393586216
67433,2068,9,1,10,M,28.756649604046935
89955,2068,2,4,6,N,29.04398642843435
17035,2068,5,0,5,Q,28.927935676663147
24398,2067,4,2,6,E,29.251643114258304
129319,2068,3,1,4,N,28.516486765849702
60973,2067,7,0,7,E,29.20719895857018
95469,2067,5,1,6,M,28.766732559268657
157710,2068,3,0,3,J,28.913400057027715
92891,2068,2,3,5,Q,28.77247977991098
75767,2067,3,1,4,D,29.284854567664244
125633,2068,6,2,8,E,28.87296694756671
104283,2067,10,2,12,I,28.98526247801086
48392,2067,6,0,6,E,29.105809647575903
62305,2067,8,2,10,J,29.088241677023564
162728,2067,1,2,3,E,29.02347050152151
93837,2068,4,3,7,N,28.977140166520087
137292,2068,8,1,9,P,28.924127764602893
133618,2067,4,2,6,J,29.31005561644671
136449,2068,3,0,3,N,28.689221246141784
21672,2067,5,1,6,P,29.202632669684085
128847,2067,4,2,6,E,29.11893127017555
77399,2068,3,0,3,D,28.61457341774326
71113,2067,6,2,8,Q,29.24889148494608
130738,2068,5,2,7,Q,28.746890868431283
77546,2068,5,2,7,F,28.806403774589715
78392,2067,3,2,5,P,29.29482133859905
130566,2067,6,0,6,C,29.46829900612483
51559,2068,5,3,8,N,29.111286358943268
93970,2068,7,2,9,D,28.859632740785436
92399,2068,1,4,5,E,29.165992100942496
100163,2067,7,0,7,N,29.218325026660672
16156,2068,5,2,7,E,29.146461165217183
131129,2067,5,1,6,N,29.25446340780908
83797,2068,4,1,5,N,29.099602410479434
102004,2068,6,0,6,A,29.11649283494356
159862,2068,2,2,4,M,28.887788609281973
20078,2067,6,1,7,E,29.21321276743693
144507,2068,6,2,8,Q,28.82785848433352
72965,2067,3,3,6,K,28.810787366813887
131819,2068,5,4,9,N,28.890368125817236
70446,2067,4,0,4,K,29.26470184123216
22206,2068,5,0,5,E,28.834017836983737
49333,2067,7,1,8,E,29.239173982373742
145199,2067,3,1,4,J,29.421571102543886
55312,2068,6,2,8,P,28.866920919818657
92217,2067,2,0,2,Q,29.14884568182568
143919,2068,3,2,5,N,29.041740882923182
46072,2068,6,3,9,K,28.6464031135569
182410,2067,2,2,4,N,29.16418363608198
160737,2067,5,0,5,N,29.204263154157637
29735,2067,5,0,5,E,28.957631170360475
125369,2068,5,0,5,E,28.538928607113164
139707,2068,3,2,5,M,29.26833966177155
108956,2068,2,1,3,M,28.69658230672541
119342,2068,5,2,7,E,29.26154042284624
23983,2068,2,2,4,A,28.675035795056274
50310,2067,5,2,7,D,29.18835088047913
70544,2067,3,0,3,P,29.149555692901163
85583,2067,3,1,4,N,29.09436468953059
132461,2068,5,4,9,N,28.610074564290915
70545,2067,4,1,5,N,29.03931654935537
160298,2067,4,1,5,E,29.10962344660157
75513,2068,2,1,3,N,28.99239818635132
138933,2068,6,0,6,M,28.74931827499333
156150,2068,3,3,6,E,28.95075368738784
122897,2068,6,1,7,E,28.668551306158527
76753,2068,6,2,8,N,29.079971446775
148039,2067,5,2,7,M,29.27618643241437
45337,2068,2,2,4,Q,28.72182895825082
169471,2068,6,0,6,N,29.07138205783952
176698,2068,6,3,9,P,28.56334430331498
157389,2068,1,2,3,D,28.579534057518718
73094,2067,5,1,6,D,29.41490137466816
127952,2068,4,2,6,Q,28.58602216668231
94961,2067,4,0,4,N,29.37150524153036
112993,2068,6,1,7,E,28.923604024505316
78732,2067,6,2,8,A,29.447481427208228
128276,2067,5,2,7,P,29.272558320248883
148558,2067,6,0,6,M,29.28759206331286
115780,2068,4,1,5,E,28.87050821656467
120126,2067,3,0,3,M,29.049314264678465
70876,2067,5,0,5,N,29.21734895889385
36736,2068,4,3,7,K,28.712370716141137
82015,2068,9,2,11,E,28.8986746495194
117630,2067,3,3,6,D,29.40303276568297
144457,2067,4,0,4,D,29.363106095069423
61346,2067,3,0,3,D,29.013882595190186
74675,2068,6,0,6,E,28.703031763047708
162867,2068,2,1,3,M,28.8178923908889
96380,2068,2,0,2,P,28.96250698502529
96134,2067,6,4,10,N,29.1909969819096
177379,2068,7,0,7,P,28.940208969416524
56445,2068,4,2,6,P,29.008276861731957
63721,2068,5,1,6,E,28.77787895713441
145026,2068,4,1,5,N,29.281671769430258
97565,2067,6,1,7,P,29.150940697423465
78677,2067,6,0,6,E,29.083438642294876
65653,2068,7,0,7,E,28.43513100138842
109058,2067,4,0,4,E,29.389745330758338
51767,2067,6,0,6,E,28.99657259430147
76034,2068,7,2,9,M,28.64321878226857
62624,2068,3,2,5,Q,28.89342392835726
76855,2067,7,1,8,M,29.57942864466925
170758,2068,3,2,5,E,28.858938401314106
102372,2068,2,3,5,E,28.960578029929064
117595,2067,3,2,5,Q,29.01606497722811
19144,2068,6,3,9,M,28.868547231481283
121184,2067,3,1,4,E,29.423412110046343
116913,2067,5,2,7,K,29.163404095628486
109202,2068,4,3,7,J,28.98023193820638
120441,2068,6,1,7,N,28.909622252838783
111596,2067,7,2,9,D,29.38762472757633
127946,2068,7,1,8,E,28.81525191618782
41863,2068,4,1,5,A,29.033557510507567
39567,2068,9,4,13,C,29.242134046368577
173865,2068,7,2,9,E,29.0074809316467
107445,2067,3,1,4,J,29.15886689690684
142931,2068,3,2,5,I,29.09460008049885
96545,2067,4,2,6,J,29.23084291516879
127123,2067,3,1,4,M,29.124722988435227
56436,2068,3,0,3,D,28.95320978130807
139919,2068,3,2,5,S,29.032577995179945
135757,2068,6,0,6,J,28.939228938336008
46929,2068,0,3,3,J,28.75479258076151
123819,2067,5,1,6,K,29.26427910875804
137029,2067,3,1,4,Q,29.081326884310503
123952,2068,3,2,5,E,29.110209186555934
20519,2067,3,1,4,K,29.232432359766545
36364,2067,4,1,5,Q,29.3083635301632
54413,2068,7,2,9,H,28.898318773734637
166707,2067,6,2,8,Q,29.11224552974629
72602,2068,2,2,4,E,28.885020718602707
172531,2067,6,1,7,E,29.123336274941995
91618,2067,2,1,3,E,29.141592104562303
160698,2067,4,2,6,E,29.563211715579065
156301,2067,6,2,8,N,28.985809440954935
116866,2067,4,3,7,J,29.047027537988136
142466,2067,5,1,6,M,29.36890370727217
76174,2068,5,3,8,S,28.89557102961634
140185,2067,7,2,9,M,29.28578065366161
170630,2067,1,1,2,A,29.26219255299036
96635,2067,5,2,7,N,29.193330617498496
132891,2067,4,3,7,K,29.478696401653725
130725,2068,5,2,7,M,28.787787257163703
23725,2068,12,3,15,I,28.809373107253435
45730,2068,4,2,6,E,28.75367350931448
144898,2067,8,1,9,J,29.3017045034966
62935,2068,5,1,6,N,28.73762111934348
65895,2068,5,1,6,M,28.79606522708287
143122,2067,5,2,7,Q,29.34626723016576
25252,2068,6,2,8,E,28.84969272191408
47740,2068,3,2,5,N,28.422792815945037
77156,2067,6,0,6,N,29.377035142256524
76509,2068,9,1,10,D,28.463040826643613
143628,2067,6,1,7,M,29.18640825527003
114205,2067,6,0,6,J,28.82141400718244
113558,2068,3,1,4,P,28.71332916743615
100321,2067,4,1,5,N,29.24193172013084
177185,2068,10,2,12,M,28.402771504650705
78269,2067,5,1,6,E,29.325995540655157
73149,2068,7,1,8,Q,28.88531695922111
52072,2068,5,4,9,P,28.85774160485081
86744,2068,6,0,6,Q,29.15764984906987
130534,2068,4,1,5,M,28.66210244977711
93852,2067,7,3,10,K,29.283396821148887
16801,2068,1,3,4,D,28.84277505536274
105349,2068,6,0,6,J,28.913051073931808
57079,2068,7,0,7,M,28.936940951182056
104586,2068,8,2,10,E,28.928908563897323
140067,2068,3,2,5,E,28.92879212518475
35751,2068,4,1,5,N,28.71820570372354
117095,2068,10,5,15,J,28.984759274475664
37204,2068,4,2,6,K,28.909735600642
142495,2068,4,2,6,M,29.06508219680803
131885,2067,2,1,3,E,29.25261288421327
94005,2068,6,2,8,N,28.73682942145157
102931,2068,4,0,4,Q,28.918303525375038
72835,2068,3,2,5,P,29.05913842973016
16694,2067,3,3,6,P,29.145449155955102
64731,2068,4,0,4,D,28.656416511744613
95093,2068,4,2,6,N,28.72700628869476
81551,2067,3,2,5,P,28.755789655973302
141236,2068,7,1,8,N,28.81753951663116
41762,2068,2,3,5,M,29.008828209696045
147378,2068,6,1,7,M,28.76496253823246
174825,2067,10,3,13,I,28.910233042540693
182932,2067,7,1,8,M,29.273049138253835
52706,2068,3,2,5,E,28.79725027289345
56439,2067,8,2,10,P,28.90869143377339
182410,2068,3,1,4,N,28.615693434089483
49352,2067,2,0,2,E,29.10540913881016
105966,2067,8,2,10,J,29.05161600940104
124072,2067,4,3,7,Q,29.38629840724347
49022,2067,1,2,3,E,28.91112759314009
98897,2067,1,2,3,D,29.419332092759163
157139,2068,3,2,5,N,28.74548911816481
124501,2068,4,2,6,M,29.192945108258225
94730,2067,6,1,7,M,29.32956117095287
158873,2068,9,1,10,N,28.97867468539503
128560,2068,4,1,5,P,28.56758151801898
96942,2068,3,1,4,E,28.760976062657654
113162,2068,6,1,7,E,28.731922550032067
18404,2067,6,2,8,N,29.268965349449413
101490,2068,1,3,4,E,29.08399427657587
155961,2067,5,1,6,N,29.302619885000453
111071,2068,8,1,9,Q,28.78694233384069
138666,2067,3,3,6,A,29.5490335553692
23710,2067,6,2,8,D,29.291786306064463
45440,2067,13,1,14,A,29.238505699464444
83853,2067,2,4,6,N,29.133194183749545
164047,2068,3,2,5,H,28.87862907563168
115237,2067,0,3,3,F,29.17367121332381
169492,2068,6,0,6,P,29.03673515859109
111273,2068,4,0,4,A,28.371886659873592
44715,2068,8,2,10,N,28.98513136310595
107674,2067,5,1,6,K,29.07155919283963
68889,2067,3,0,3,E,29.374034316930373
148774,2067,6,0,6,P,28.93895465674509
168074,2068,4,2,6,J,28.698087476491228
172317,2068,7,0,7,M,28.51724723439221
102566,2068,4,1,5,E,29.050083276355103
32598,2068,5,3,8,D,28.8878466613578
158135,2068,3,1,4,N,29.016990449229368
117111,2067,6,2,8,E,29.16396452421922
21812,2068,5,0,5,J,28.987488924762715
149504,2068,4,0,4,J,28.83074075502727
148183,2068,6,1,7,M,28.78886239260203
146162,2068,6,2,8,J,28.759203198287207
28780,2068,5,1,6,E,29.06729579410148
58759,2067,4,2,6,E,29.4216357114156
45915,2067,6,3,9,N,29.20415263308864
144737,2067,6,1,7,K,29.277144646802277
48899,2068,2,2,4,E,28.91361047458529
38007,2068,6,0,6,J,29.009033838384923
173263,2068,3,0,3,K,28.96533304582527
121941,2067,7,2,9,E,29.2458040433791
28165,2067,4,0,4,D,29.45377183870739
146787,2067,6,1,7,A,29.238426639215277
56785,2067,6,0,6,M,29.30232627068699
156310,2068,3,4,7,N,29.1188712939582
63746,2068,4,1,5,N,28.832220304981245
145571,2068,1,4,5,M,28.59738856432637
104292,2067,5,2,7,E,29.18788388577133
176278,2067,2,2,4,Q,28.89263317960339
30132,2067,4,2,6,E,28.953409694190384
33240,2068,4,0,4,E,28.801046288369484
148538,2067,5,0,5,K,29.30826798925531
165806,2067,5,3,8,E,29.132447734839
96843,2067,2,1,3,N,28.9220022834609
81738,2068,2,0,2,N,28.949339066085464
148433,2067,4,6,10,P,29.25503934249809
26061,2068,6,1,7,Q,28.60396037795465
55675,2068,2,3,5,P,28.682549161230263
22081,2067,5,1,6,Q,29.180525133226425
116498,2067,1,4,5,J,28.94564612082825
48737,2067,5,2,7,N,29.326315822980405
87912,2067,8,2,10,J,28.8597797566234
64693,2068,9,4,13,L,28.79076752460351
98317,2067,3,1,4,N,29.5902174475929
150190,2068,5,1,6,Q,29.081513572777176
24103,2068,3,2,5,R,28.939529592206707
66705,2067,4,2,6,E,29.269210093047388
173486,2067,2,2,4,E,29.17117662425069
21387,2068,6,1,7,P,28.84104771486805
122912,2067,7,0,7,E,29.22588782891153
78648,2068,5,0,5,J,28.813385502429966
105317,2068,4,2,6,M,29.243597436491317
54588,2067,4,0,4,Q,29.1268062995944
111209,2067,2,2,4,E,29.17817779141977
173759,2067,4,3,7,P,29.22637630591247
123557,2068,6,0,6,N,28.81201749897372
71565,2067,2,0,2,N,29.24503105754248
159911,2068,5,1,6,N,28.86182342660325
125123,2067,4,1,5,K,29.42690179906061
100863,2068,3,2,5,Q,28.7578496766607
175759,2068,1,3,4,L,28.805644402191604
125240,2068,3,1,4,J,28.881438857236475
159080,2068,6,3,9,E,28.647230660128223
89773,2068,2,3,5,E,28.58524087186439
125566,2068,3,1,4,D,28.54312362621319
124074,2067,6,1,7,N,28.99870806480124
37484,2067,6,3,9,C,29.12773023835137
77400,2067,5,4,9,M,29.116385500203965
75058,2068,5,2,7,P,28.839030484038005
95332,2068,4,1,5,P,29.13940498908753
108907,2067,1,2,3,K,28.949670278651507
89373,2067,4,2,6,G,29.184999345323277
27399,2067,7,2,9,N,29.448947638787004
117674,2067,6,1,7,E,29.32609132343103
17095,2067,6,1,7,E,29.16018238787099
128114,2067,5,1,6,E,29.48870033423202
133768,2067,4,1,5,E,29.10235848403097
98895,2068,3,1,4,E,28.684849049467264
47024,2067,5,2,7,N,29.19404900217645
36207,2068,6,0,6,Q,28.939964755895566
146236,2068,7,1,8,M,29.179455897035517
70735,2068,3,1,4,M,28.798471282243263
142224,2067,6,1,7,N,29.091719025268933
174603,2068,3,1,4,E,28.982602625441555
16111,2067,6,0,6,Q,29.34666289484325
134011,2067,6,0,6,K,29.279798924566972
87271,2068,2,3,5,E,29.103683442190007
41056,2068,3,0,3,N,28.648003348526164
113295,2068,5,1,6,P,29.03050292361443
86957,2068,7,0,7,N,28.76616210595164
97750,2068,4,2,6,N,28.755111664859136
127379,2068,5,3,8,E,28.511664717581382
134770,2067,7,2,9,K,29.087983233425028
73834,2067,3,2,5,N,28.988300195162207
17473,2067,4,0,4,A,29.198318846294075
68439,2068,5,2,7,N,28.6989478712565
70774,2067,2,3,5,N,29.031481743076903
110366,2067,6,1,7,E,28.932092494428357
48749,2067,5,1,6,S,29.411166623595108
78035,2067,6,1,7,Q,29.13396292716032
94911,2067,4,0,4,N,29.129468140595325
79513,2068,6,1,7,Q,28.90313419816954
23887,2068,3,1,4,D,28.73227206752822
168043,2068,6,0,6,E,28.913836984456218
88722,2067,4,1,5,Q,29.012675951802485
158697,2068,4,2,6,E,28.73100723800316
15808,2067,5,2,7,D,29.316728873627287
144578,2068,5,0,5,N,28.955319469526767
70568,2068,3,1,4,E,28.95489548789551
103502,2068,4,0,4,N,29.23749335826581
162396,2067,3,2,5,C,29.27671859627733
38538,2067,4,0,4,N,29.240424207887173
146754,2068,5,3,8,P,29.017166008178904
85049,2067,6,2,8,C,29.004264982986346
30317,2068,2,2,4,M,28.659086676306764
160159,2068,1,3,4,M,28.95978895902832
32395,2068,4,2,6,D,29.07507169605448
92864,2067,4,1,5,E,29.32267017681617
176969,2068,6,1,7,E,28.693167393508503
146432,2068,5,2,7,E,28.717753794555367
74585,2067,6,1,7,Q,29.211419540251267
61916,2068,5,0,5,E,28.876386899715907
110189,2068,3,0,3,K,28.51441847559256
161670,2067,4,1,5,H,29.045746419391172
176576,2068,3,0,3,D,28.98391139750322
120335,2067,1,1,2,N,29.15838660642977
114068,2067,7,0,7,E,28.896323382400546
148470,2067,7,0,7,M,29.295694545640508
128322,2068,4,1,5,N,29.10365432416149
148872,2067,4,0,4,P,28.99060693070536
158170,2068,5,3,8,E,28.45823030488693
129107,2067,2,0,2,Q,29.040559663450686
125682,2068,5,1,6,J,28.85578299769368
146682,2068,3,4,7,D,28.82054534280074
70741,2068,4,1,5,M,28.79585315287407
109720,2067,6,2,8,M,29.58905455596261
78227,2067,2,2,4,S,29.36152056844124
97176,2068,3,1,4,K,29.097845843822004
166216,2068,5,2,7,N,28.953262041672154
97861,2067,13,1,14,E,29.193551160232698
26296,2067,6,2,8,I,29.407532069520943
54766,2068,5,4,9,S,28.95653146267847
75705,2067,4,5,9,M,29.008381295291112
137676,2067,7,2,9,K,29.29233257712187
175832,2068,2,2,4,M,28.609269777757007
95032,2067,4,0,4,J,28.91749229039867
116186,2068,6,1,7,P,28.747627635512483
82316,2068,3,0,3,E,29.136222211558515
17826,2067,6,0,6,A,28.909501698371876
96039,2068,6,2,8,J,28.813873588726
24050,2068,5,1,6,E,28.924185675162104
34116,2068,6,1,7,I,28.792128881630063
103136,2067,2,1,3,D,29.399124550770527
64674,2068,6,0,6,D,28.831126467564445
121509,2067,5,3,8,E,28.927307274881
23524,2068,5,1,6,D,28.940697235115884
54151,2067,1,1,2,N,29.43892133979612
165578,2067,3,0,3,J,29.32795209296121
63850,2068,1,1,2,D,28.868985516618896
69459,2068,5,1,6,E,28.86970937601328
63768,2067,5,1,6,E,29.22271234985835
146396,2068,4,3,7,M,29.08911564278771
19743,2067,5,1,6,P,28.97947752587825
64731,2067,4,1,5,D,29.595319041888544
98945,2068,5,0,5,D,29.092476146234784
162779,2068,2,3,5,N,28.6222202171058
122065,2068,4,1,5,Q,28.83554318701432
119833,2068,6,1,7,E,29.008222498674638
19840,2068,4,0,4,C,28.468951301753098
85396,2067,5,1,6,N,29.217476114673985
91807,2068,3,3,6,N,28.96858835354323
22460,2068,4,2,6,S,29.12583304060806
136599,2067,1,1,2,D,29.18438651374346
161060,2068,4,0,4,M,28.839887901136184
157596,2068,3,1,4,A,29.01828520209305
160727,2067,6,2,8,N,29.16862448999858
27143,2068,6,2,8,E,29.04649413604778
172723,2067,3,1,4,E,29.31497372226064
47833,2067,2,1,3,N,29.40881579965133
65751,2067,10,2,12,D,29.13496780702155
35533,2067,3,0,3,P,29.18766798977393
157232,2068,1,1,2,N,28.8547556284315
60769,2068,6,2,8,J,28.95632110329425
54004,2067,2,0,2,E,29.178315659736167
146252,2067,4,0,4,N,29.098819419852568
92827,2068,2,1,3,A,28.63113247651316
122437,2067,2,2,4,N,29.22534243709676
166763,2068,3,1,4,N,28.891926919615265
67843,2067,4,1,5,N,28.92121680475673
175152,2068,2,0,2,N,29.015999570491516
28503,2068,2,1,3,M,29.051677920619536
112816,2068,5,2,7,K,28.79629968474545
89575,2067,5,1,6,M,29.03002417368656
89958,2068,3,2,5,D,28.84465022275296
138300,2067,3,2,5,P,29.12803495759597
16481,2068,4,2,6,D,28.939049903062664
147305,2067,3,2,5,M,29.15275460012341
176264,2067,3,3,6,S,29.362641050734453
167132,2067,4,0,4,E,29.138207621350567
87679,2067,5,2,7,Q,29.17308177684875
60074,2067,6,2,8,J,29.42739988791464
159805,2068,5,0,5,K,29.013843895161568
50008,2068,4,1,5,P,29.09630965901393
32300,2068,5,2,7,D,28.657692728413515
69033,2068,5,1,6,M,28.75763905094385
59080,2067,5,0,5,K,29.22483188701708
127955,2068,10,0,10,E,28.893311772255807
85402,2067,7,4,11,I,29.22500186819088
45563,2067,2,0,2,N,29.077754124619226
176150,2068,6,0,6,Q,28.739512545011557
145976,2067,5,1,6,C,29.22117506156828
111656,2067,10,2,12,M,29.18123203908116
27587,2068,4,3,7,N,28.686460677359108
136986,2067,4,1,5,E,29.018000444332756
105703,2068,2,2,4,S,28.821822158425935
181155,2068,0,4,4,N,28.868808802960952
140241,2068,5,0,5,P,29.359796209349938
22350,2068,5,1,6,Q,28.83764738387476
157528,2067,4,1,5,N,28.877591259951725
36763,2068,3,1,4,N,28.68451679422225
110739,2067,1,3,4,K,28.99814512400124
138481,2068,1,2,3,I,28.95798635001356
87262,2068,5,2,7,Q,28.683822343382875
114841,2068,5,2,7,E,28.736463437277614
156607,2067,9,0,9,D,29.14348841572462
41073,2068,3,1,4,E,28.77688863495397
144683,2068,4,1,5,Q,28.96773921693275
148384,2067,2,1,3,M,28.9424484972752
149027,2068,6,2,8,M,28.65999202498931
26599,2067,5,0,5,E,29.29912945616534
122606,2068,4,1,5,E,28.84174602070453
86453,2067,6,2,8,J,28.883153379301195
123654,2067,7,3,10,N,29.091644680758076
104563,2067,5,0,5,Q,29.138525328724484
124823,2068,3,0,3,Q,29.045328115257387
113505,2068,5,2,7,E,28.942717210647203
97566,2067,7,2,9,E,29.275818710744144
89868,2067,6,2,8,N,29.175525637721424
44992,2068,4,1,5,N,28.814151119466157
113962,2067,8,3,11,E,29.2086395327852
60122,2068,3,0,3,M,28.884007339844604
167506,2068,4,1,5,S,28.612972942234904
91760,2068,5,2,7,J,29.022074699421253
26629,2067,5,1,6,C,29.002730280234005
156829,2068,6,2,8,N,28.73869356066364
47927,2068,6,1,7,I,28.79760812034547
145660,2068,10,1,11,P,28.82510990055817
94587,2068,13,2,15,D,28.95502228314581
136534,2068,2,0,2,E,28.8982285888072
169420,2068,5,0,5,D,28.76926046286585
142494,2068,6,1,7,P,29.121619445215572
62479,2068,3,1,4,E,28.776890549071144
31381,2068,2,2,4,L,29.001537730774768
125724,2067,3,0,3,P,29.211787060520237
174397,2067,5,1,6,N,29.31350051162816
145324,2068,5,1,6,S,28.83385210234801
156479,2068,9,0,9,D,28.748086972192645
179233,2067,7,0,7,K,28.992715999542494
60176,2068,2,2,4,D,29.082335146138263
23597,2067,4,1,5,J,29.447690922932683
114680,2068,6,1,7,J,28.97175328940453
82038,2068,4,1,5,N,28.94519078973721
137036,2067,6,1,7,M,29.161041823918797
120026,2068,4,4,8,E,28.710893233576115
181347,2068,3,3,6,D,28.91094939477881
110154,2068,3,2,5,E,28.91302709507253
151115,2068,5,2,7,M,28.656491504453346
73471,2067,2,2,4,S,29.36819485289945
27295,2067,4,0,4,K,28.938955687782016
109386,2068,3,3,6,N,28.855447896456567
63570,2068,5,2,7,E,28.94825711803448
40065,2067,4,2,6,S,29.29374100737602
174314,2068,2,0,2,K,28.78456366248411
23567,2067,6,0,6,A,29.36888181767817
51657,2067,4,1,5,S,29.02847301406554
124276,2068,10,2,12,N,29.140868091936103
81215,2068,9,1,10,D,28.8551707064556
35996,2067,8,2,10,E,29.089014166266654
71079,2068,4,1,5,D,28.68971964505041
27093,2067,2,1,3,P,28.91499346185493
106101,2068,4,1,5,J,28.757861833925457
162219,2067,6,1,7,N,29.09560967799221
95915,2067,3,2,5,N,29.399032305316
128421,2067,6,2,8,M,28.97788009922414
63829,2068,3,3,6,S,29.018854060031828
27760,2067,8,2,10,E,29.467493872374263
78621,2067,4,2,6,M,29.442850329877604
95747,2068,4,5,9,I,29.09132263143788
151282,2068,6,0,6,P,28.952000834131606
134070,2067,2,1,3,K,29.227507507643335
122436,2068,5,2,7,J,29.07416931417344
128833,2067,5,2,7,E,28.825537813352188
119177,2068,5,1,6,E,28.833940866678628
142521,2068,3,1,4,J,29.18239093934601
41200,2068,3,1,4,M,28.6813083464572
137259,2067,7,0,7,D,29.16852626739693
30397,2068,4,1,5,D,29.05406384635453
174081,2068,5,3,8,J,28.7904719687534
148164,2067,5,0,5,M,29.400834333391924
103230,2068,12,3,15,E,28.98860656642553
139790,2068,4,3,7,E,28.91451128450551
157087,2068,5,2,7,E,28.7583935978403
74906,2068,7,0,7,N,28.782669052189625
56068,2068,6,2,8,A,29.08835152807248
49475,2068,6,2,8,J,28.539935213938094
85583,2068,6,0,6,N,28.783054846535386
59232,2067,10,2,12,D,29.037076088343248
27293,2068,6,0,6,E,28.820524078966542
27907,2067,5,1,6,N,28.98957664536812
20082,2067,4,3,7,E,29.063592656070263
73494,2068,5,1,6,M,28.76492459885136
172661,2067,9,2,11,F,28.94990000073118
90023,2067,9,1,10,A,28.97539163690133
110611,2067,3,3,6,E,29.201231478141057
134172,2068,3,1,4,N,29.23553124204966
112707,2068,2,2,4,E,28.93662119247113
82246,2068,4,0,4,N,28.91763100083104
113914,2067,7,3,10,J,29.04356682714278
160541,2067,7,1,8,P,29.00767699833073
31259,2068,5,1,6,C,29.09520119078144
131196,2068,4,3,7,N,28.60659415061741
65514,2068,8,3,11,A,29.24017303431077
28958,2067,5,2,7,E,29.215510090071987
110635,2068,2,2,4,J,28.95247333351095
25364,2068,4,1,5,N,28.67822379558009
164830,2067,3,3,6,M,29.29716492848216
146511,2068,6,1,7,M,28.89639757451142
92473,2067,5,0,5,M,29.24309463183805
115903,2068,3,2,5,E,29.174773047033938
26811,2068,5,0,5,Q,28.792714345180663
24365,2067,5,3,8,N,29.24280107062913
63532,2068,5,1,6,M,28.837779032193623
87778,2068,4,2,6,E,29.01750374238077
39731,2067,2,1,3,J,29.08789500117007
182530,2068,4,1,5,Q,28.815485988389437
174998,2068,1,1,2,P,28.88316164744659
73835,2067,3,1,4,P,29.0637102937306
159036,2067,4,1,5,E,29.34453525352795
109777,2067,4,2,6,J,29.165168008177982
86192,2068,4,2,6,J,29.011815814109536
48016,2068,3,0,3,J,28.714868747324967
143336,2068,2,2,4,K,28.74075617752423
146281,2067,6,2,8,M,29.38693214911379
125696,2067,3,1,4,M,29.224930969243
92907,2067,7,2,9,N,29.3134300071731
136584,2067,5,0,5,D,28.97896117392416
123527,2067,6,1,7,F,29.122040269223483
72974,2067,4,0,4,E,29.343562153006715
62128,2068,5,3,8,N,28.79223508613408
54169,2067,2,2,4,F,28.916807559770582
62740,2068,3,1,4,J,29.14411766380166
167763,2068,4,0,4,D,29.08758426454863
79539,2068,6,3,9,E,28.82558507467116
181361,2067,2,1,3,N,29.195568109452097
115087,2068,6,0,6,M,28.760747097053443
124325,2067,6,0,6,E,29.172952519562863
144824,2068,7,1,8,N,28.872861875920616
147527,2068,7,0,7,P,28.67801740577904
136312,2067,3,2,5,J,29.36344721126185
114529,2067,4,2,6,M,29.010352224878385
90279,2067,0,4,4,P,29.011567680923008
147773,2068,7,0,7,K,28.77274406201272
16018,2067,2,1,3,N,28.951702344240264
122710,2068,5,2,7,C,28.708596620784608
137246,2068,3,1,4,N,29.11172145295872
117951,2067,2,0,2,N,29.388570127263232
94158,2067,3,1,4,N,29.540931721465327
110608,2067,2,1,3,D,29.14453751482718
83580,2067,3,3,6,J,29.618783755539823
59459,2067,8,2,10,M,29.58954252499131
50818,2068,6,3,9,J,28.91460371971121
114010,2067,4,2,6,N,28.972450117421847
134893,2067,6,2,8,Q,29.101040519078968
133029,2068,4,1,5,E,28.71636577084742
27251,2067,8,8,16,L,29.15024578641748
77489,2067,6,0,6,M,28.87185644619072
90063,2068,4,2,6,N,28.91979094323152
79345,2068,7,2,9,P,28.947431220013623
170694,2068,3,0,3,E,28.94720887185873
103627,2067,4,2,6,J,29.55483839513239
94580,2067,6,3,9,J,29.3308518615605
98091,2068,7,1,8,N,29.126913730180487
140612,2067,6,2,8,M,29.2955710275621
183249,2068,3,1,4,M,28.996000493399897
91736,2067,7,2,9,N,29.22154307535856
95122,2068,2,2,4,E,28.77686476099278
167763,2067,5,1,6,D,29.079040008147143
181935,2068,5,0,5,M,28.859587906645203
38117,2068,6,0,6,Q,29.291605354138397
107888,2068,8,4,12,Q,28.84161314997414
16822,2068,5,0,5,R,28.965856932728613
83602,2067,3,2,5,E,29.00259196495438
164986,2067,2,4,6,M,29.15558080426812
24973,2067,14,5,19,J,29.096461953519466
104879,2068,6,3,9,Q,29.165805856236798
179064,2067,10,0,10,N,29.20382606219073
49077,2067,2,2,4,E,29.06331052842567
151066,2068,2,2,4,K,28.850397449195704
87305,2067,5,0,5,C,29.340653719202045
99232,2068,4,1,5,E,28.71729447920153
83983,2068,2,2,4,D,28.71172302472141
150220,2068,2,1,3,M,28.56365966597944
132797,2068,8,2,10,J,28.882628561300265
68529,2067,7,2,9,I,29.23419767207637
89330,2068,4,2,6,Q,28.712181529914677
22384,2067,1,2,3,M,29.25823711210111
59745,2067,3,1,4,N,29.382332416719777
23716,2068,6,0,6,Q,28.94145556876482
131792,2068,6,0,6,Q,28.90908170850248
108821,2068,3,1,4,J,28.87256840203455
28570,2068,6,0,6,K,29.20332599749236
21224,2067,1,2,3,D,29.436133146422872
71614,2068,4,1,5,E,28.77228929340331
37702,2067,3,1,4,P,29.395787745107643
41476,2068,6,2,8,N,28.51793529278654
122401,2068,2,1,3,A,28.793226188248013
128816,2068,6,3,9,P,28.787413107584666
121141,2068,2,0,2,Q,28.82749371304487
33927,2067,4,2,6,E,29.482144987766056
54813,2067,2,2,4,M,28.8865384177736
46350,2067,5,0,5,N,29.19428368534457
106041,2067,1,3,4,P,29.384035319589028
174224,2068,4,3,7,E,28.63354206706516
130453,2067,7,2,9,M,29.34966408881269
46402,2067,2,2,4,J,29.21753622337867
147933,2067,6,2,8,N,29.007729428950064
146743,2068,4,1,5,Q,28.870984131349516
38822,2067,7,0,7,E,29.054957554536497
36692,2067,3,0,3,Q,29.471778272884325
133944,2068,2,3,5,J,28.91566886257614
84705,2068,2,2,4,K,28.660669681786608
149454,2068,8,2,10,E,28.76336198673112
126983,2068,2,1,3,M,29.288990434163424
85576,2067,6,2,8,I,29.17688628890063
165052,2067,4,1,5,E,29.21585833702666
28199,2068,6,1,7,M,28.74703488478176
54374,2068,6,3,9,S,28.816568354178735
63634,2067,5,0,5,D,29.0899826367938
123169,2067,6,2,8,P,28.994305325708705
23514,2068,3,0,3,E,28.982454949706742
102458,2068,7,2,9,E,29.061777936663823
77886,2067,13,2,15,M,28.886996447170944
48508,2067,5,1,6,K,29.13264494642136
18867,2068,2,3,5,Q,28.83840149650906
145641,2067,6,1,7,K,29.558391553127898
59134,2068,9,1,10,J,28.96716752341343
110459,2068,2,1,3,S,28.8105219364916
76281,2068,3,2,5,M,28.96916401692966
27061,2067,1,2,3,N,29.139741462595104
123701,2068,4,0,4,Q,29.04950077483848
165406,2068,6,2,8,N,28.941595537131303
112342,2067,10,2,12,J,29.3478338772578
59614,2067,4,0,4,D,28.949900353873435
117576,2067,2,2,4,K,28.96089711224044
106785,2068,5,2,7,N,29.080195149827706
39931,2067,5,1,6,N,29.43234964590367
37634,2068,2,3,5,E,29.050246590289674
90140,2068,5,0,5,J,29.22351357381992
122095,2067,4,2,6,E,29.04199411694268
49003,2067,7,2,9,J,29.183210767127967
26812,2067,5,2,7,N,28.91219028111076
78598,2068,4,2,6,Q,29.076642106273923
107316,2068,5,0,5,N,28.51304836259915
139805,2068,4,0,4,N,28.62905217549375
139360,2068,6,2,8,P,28.808091397086063
137955,2068,6,2,8,E,28.988304123872947
175022,2068,2,0,2,N,29.14485676268095
120516,2068,6,3,9,J,28.950645456771877
63120,2067,7,0,7,E,29.28586516105816
38420,2068,9,2,11,J,28.70514709794543
108956,2067,3,2,5,M,29.233102622694656
99310,2068,7,2,9,N,28.891907895370696
177485,2068,6,0,6,Q,28.63170372677632
39732,2068,4,1,5,E,28.743359678374983
24014,2067,7,1,8,K,28.96147167892907
44711,2068,0,4,4,N,28.838000158295884
18341,2068,4,1,5,E,28.88339923420573
54113,2068,3,2,5,N,28.849913436038445
147728,2067,6,2,8,E,29.244831966638976
130819,2067,5,1,6,E,29.08253372486724
127860,2068,3,3,6,M,28.847595096021017
139023,2068,2,0,2,Q,28.606492626036548
133594,2067,2,3,5,N,29.141942016075312
148636,2067,7,3,10,Q,28.928330339776696
132278,2067,3,1,4,E,29.24624394901603
64295,2068,3,2,5,D,28.72124541345136
19725,2068,4,3,7,J,28.78223225780737
179939,2067,4,0,4,P,29.098348335212563
111993,2067,6,1,7,Q,29.26370481409719
59004,2067,5,1,6,N,29.27889662224245
94591,2067,5,2,7,P,29.03496728803585
107741,2068,3,0,3,P,29.02571805133214
158019,2068,7,1,8,H,28.866419552487702
163013,2067,4,1,5,E,29.49641417340182
127436,2067,6,3,9,S,29.10042728695744
46535,2068,1,3,4,N,28.82290117450229
98588,2068,5,1,6,J,29.0736514813015
39632,2067,5,1,6,P,29.42417557669206
144914,2067,4,1,5,K,29.28084757429812
16365,2068,11,1,12,D,28.851192076514124
175660,2067,3,0,3,N,28.997089855093726
109226,2068,4,2,6,F,28.70550674749837
42748,2068,3,3,6,N,28.7734524281192
106742,2067,6,1,7,D,29.22204880049868
96102,2068,2,1,3,N,28.804413713771968
138285,2068,4,2,6,N,28.838011725730453
96987,2067,7,2,9,N,29.13184748466037
109252,2067,6,1,7,N,29.11221505135083
133740,2068,3,0,3,E,28.62592760446404
105952,2068,5,2,7,E,28.999920931104903
161270,2068,4,2,6,P,28.5201050533867
57053,2067,4,0,4,S,29.260124243505224
92827,2067,5,0,5,A,29.40530502738566
36365,2068,7,0,7,M,28.45777119262504
32777,2067,3,2,5,P,29.51962058551389
148549,2068,7,1,8,M,28.905116537591468
111188,2067,2,2,4,D,29.27037278632175
20741,2067,3,0,3,M,29.23959358156513
93495,2067,4,1,5,E,29.312979195238917
69962,2068,4,3,7,P,28.98452403496925
88183,2068,4,0,4,E,28.75480367660164
107153,2068,5,2,7,E,28.712779756538097
121862,2068,4,3,7,M,28.71476478572766
61118,2067,2,2,4,N,29.23408076896659
86551,2068,4,1,5,Q,29.07290117343996
108532,2067,5,1,6,D,29.043877247281184
45429,2068,6,3,9,D,28.75009962177075
21214,2068,6,2,8,C,28.893582495186426
56322,2068,3,2,5,E,28.801114114779264
104126,2067,4,3,7,E,28.98206458954716
122826,2068,6,2,8,Q,28.873583100784696
173470,2067,3,3,6,P,28.76597740578233
110275,2067,11,1,12,H,28.99426538456509
38131,2068,4,0,4,E,28.88475479621472
172456,2068,10,0,10,R,28.919156682703075
78851,2068,2,3,5,C,28.872983448769094
54266,2068,4,2,6,N,28.46263532861126
175025,2067,10,3,13,M,29.33892981803199
145938,2068,3,2,5,M,28.957526548428238
162647,2068,9,2,11,E,29.03978017132393
30564,2067,6,1,7,E,29.257052717821225
110322,2067,4,0,4,P,29.12679579917716
31168,2067,4,1,5,F,29.41140290515705
166629,2068,6,2,8,N,28.88894262452464
65325,2067,5,2,7,E,28.873285991709484
24969,2067,5,2,7,J,29.32114220488375
95168,2068,16,6,22,F,28.673519214011638
74007,2067,5,2,7,N,28.96131415073648
150608,2068,6,4,10,P,28.664963817742425
36027,2067,16,1,17,E,29.22653288530422
98217,2067,3,0,3,E,29.115816002988755
45078,2067,2,3,5,N,29.102831368095217
59242,2068,3,1,4,P,28.82559217287927
118954,2068,4,0,4,N,28.693977152310165
75534,2067,5,2,7,N,29.06981133924952
93733,2067,6,2,8,J,29.057726994836734
121891,2068,5,1,6,E,28.59712200234914
93682,2067,2,2,4,S,29.295151320018984
146793,2068,8,1,9,P,29.390597647019764
100824,2067,2,2,4,K,29.119708435131336
98062,2067,3,2,5,J,29.155283813483795
170975,2068,1,3,4,C,28.641464207812334
50795,2067,2,2,4,S,29.024117308503165
76133,2068,5,1,6,Q,29.373946217626525
108896,2067,3,3,6,M,29.188047391773267
59437,2067,7,0,7,E,29.107503542215078
109349,2068,2,0,2,Q,28.777629636009976
56800,2068,5,2,7,M,29.09370066696433
47761,2068,3,2,5,E,29.050433176775165
69650,2067,3,1,4,M,28.951565510770205
40562,2068,7,2,9,K,29.075151995260985
156882,2067,4,4,8,J,29.31968820227714
141479,2067,5,2,7,P,29.018974483478583
135886,2067,3,2,5,E,29.12809071752582
41646,2068,6,0,6,I,28.779364810058286
25581,2068,3,2,5,C,28.654336881797438
41252,2067,6,1,7,M,29.392869092519067
49536,2068,3,0,3,Q,28.77665897617665
178783,2067,1,3,4,P,29.424768232798893
148945,2068,2,2,4,M,28.73836333759143
120735,2067,6,1,7,K,29.314234451600026
168021,2068,6,2,8,Q,28.64921335783294
49504,2068,2,2,4,Q,29.246121805417395
17317,2067,1,3,4,Q,29.17857456483712
77341,2068,7,2,9,E,29.17952354743709
95377,2068,2,4,6,N,28.74605843716209
112462,2068,3,4,7,J,29.057662293759087
27769,2068,4,3,7,J,28.784541994231844
17735,2068,3,1,4,N,28.99044370700637
45932,2068,2,1,3,J,28.875341643519185
46480,2067,4,0,4,N,29.072918394035923
144900,2067,6,1,7,M,29.122353483047075
93441,2068,8,1,9,N,29.02251881593889
115238,2067,4,0,4,M,28.93855412142296
24296,2067,9,4,13,J,29.229456349297177
156066,2068,5,0,5,N,28.93895695319332
159771,2068,5,3,8,S,29.094793252702917
113498,2067,14,6,20,E,29.146894241314545
36527,2067,6,0,6,M,29.454648244480257
179592,2068,5,2,7,E,28.780413690528206
76121,2067,3,0,3,P,29.282960845722712
141257,2067,3,4,7,E,28.99648906716834
163544,2067,3,2,5,M,29.45541812482925
136171,2068,3,0,3,Q,28.762690469595952
84910,2067,3,0,3,D,29.38524593682513
149726,2068,2,4,6,M,28.716648830130477
173241,2067,7,2,9,D,28.930225970961985
148155,2068,7,2,9,M,28.91794228630228
140629,2068,4,0,4,K,28.958858154870438
39970,2068,4,1,5,J,28.882425253514764
165172,2068,3,3,6,S,28.497075912754852
160450,2068,5,0,5,H,28.756038548741856
149387,2068,5,0,5,Q,28.926942463623305
148851,2068,5,3,8,M,28.73850375940687
112126,2068,5,1,6,J,28.795190925256527
131617,2068,5,2,7,M,28.791514552090803
38595,2067,7,2,9,H,29.008897613572685
145496,2068,4,1,5,N,29.284354211186848
36027,2068,16,3,19,E,28.95453369282448
120345,2067,3,1,4,E,29.18145048845207
67215,2068,5,2,7,N,28.967303248437545
110708,2067,5,1,6,J,29.147854307266357
131085,2068,3,1,4,P,28.88886750414153
45143,2067,3,0,3,E,29.196135147343224
73103,2068,6,1,7,H,28.976058827837647
111814,2068,4,0,4,M,29.05235024171501
54909,2067,6,0,6,Q,29.20139319957039
50005,2067,7,2,9,K,29.41452745304102
171400,2068,2,2,4,E,28.886113533383178
165605,2067,2,3,5,N,29.4418808232453
137058,2067,4,0,4,M,29.154647455801083
164657,2067,7,2,9,L,29.168747511614196
148661,2068,5,2,7,F,28.785754543366203
55573,2067,5,0,5,N,29.16571243019533
29154,2067,6,0,6,D,29.193789165018103
90378,2067,3,1,4,E,29.253978238783915
165740,2067,4,2,6,M,29.163880575474245
101321,2067,3,2,5,J,29.15676382990381
158957,2067,5,1,6,M,29.130461806382783
55197,2068,3,3,6,E,28.914752797810912
59405,2068,3,1,4,K,28.7455813098387
162084,2067,1,2,3,P,29.19736795481485
129688,2067,4,2,6,A,29.492433709333124
16533,2067,4,2,6,A,29.0225873487793
113096,2067,0,3,3,J,29.154838956967755
143936,2067,7,2,9,K,29.23535724132743
180383,2067,2,2,4,N,29.198164241390018
29948,2068,5,2,7,D,28.901363360536863
108893,2067,3,2,5,K,29.07677751130297
86591,2068,7,2,9,E,28.7409138929016
139942,2067,1,1,2,P,29.371644573207963
28071,2067,3,1,4,N,29.060841244657425
65074,2068,5,2,7,E,29.37616922825966
114613,2068,6,2,8,N,28.719719489995992
74224,2067,9,3,12,D,29.20300639675933
142525,2068,4,1,5,P,28.674318940322756
160460,2067,6,2,8,P,29.007917220586787
87667,2068,5,1,6,H,28.79904538351199
16096,2068,3,0,3,P,28.93195420885428
165933,2068,1,2,3,S,28.993773392208343
147006,2068,4,2,6,M,28.54893285689233
141432,2067,6,2,8,M,29.001701555535263
18349,2067,4,1,5,A,28.9656578051289
115587,2068,5,0,5,E,29.05867786706307
111019,2068,3,1,4,N,28.7165681312726
93386,2067,5,2,7,Q,29.129212143967848
137878,2067,5,0,5,S,29.148836577806467
58646,2068,8,1,9,D,28.98949411164634
105183,2068,4,0,4,N,29.01447724883009
86564,2068,4,2,6,E,29.0271460551988
144007,2067,0,5,5,M,29.237543496043397
71370,2068,2,2,4,M,28.80751092798525
167187,2067,5,2,7,M,29.147815222799355
172312,2067,5,1,6,K,28.643720190691088
102250,2068,5,0,5,S,28.963071193253462
117712,2068,5,3,8,Q,28.857029595358004
129308,2067,4,0,4,Q,29.167983006567123
63768,2068,6,1,7,E,28.780738336501432
55262,2068,2,3,5,J,28.811517765985457
77949,2068,3,4,7,M,28.745145140016334
77953,2068,4,2,6,M,28.606622169531523
93604,2067,6,0,6,D,29.32098555081016
138388,2067,3,4,7,N,29.229515503963064
107042,2068,7,2,9,J,29.21664946013809
174007,2067,4,2,6,P,28.9037287436787
122230,2068,3,3,6,P,28.66372308293325
21248,2068,6,0,6,Q,28.56799736640555
143835,2068,5,2,7,J,29.14561529187634
109246,2068,2,2,4,A,29.384015052865745
171359,2068,3,1,4,N,28.503578406081942
45557,2068,13,1,14,K,28.72675050058716
177012,2068,5,2,7,E,28.558880548474125
22011,2068,5,1,6,Q,28.74596231524082
83996,2067,2,1,3,M,29.153758053057143
124580,2068,3,3,6,N,28.916347325631182
121570,2068,2,0,2,P,28.676010636987115
122473,2067,3,4,7,N,29.201525005218876
45450,2068,4,3,7,M,28.880270720179254
59764,2067,1,3,4,J,28.83012151615034
92251,2068,5,2,7,N,28.78252955434353
22660,2067,5,2,7,N,29.17696687916532
147939,2068,4,1,5,P,28.97975142168261
121274,2068,3,2,5,N,28.93680069981
47176,2067,4,2,6,N,29.11987527524157
86957,2067,3,1,4,N,29.472931831359087
93950,2068,3,0,3,D,29.014181038925194
53533,2067,6,2,8,I,29.150699689058342
32387,2068,5,1,6,N,28.786621253262265
37804,2067,3,2,5,M,29.312601960066825
26185,2068,2,1,3,M,28.986048342920064
114112,2068,7,1,8,R,29.12851470412902
109453,2068,4,1,5,K,28.785141159321217
157963,2067,7,1,8,E,29.436741903761508
55010,2067,3,2,5,M,29.048120212219207
140342,2067,2,1,3,N,29.030963129255777
133753,2067,6,2,8,K,29.38130366743553
49103,2068,3,0,3,M,29.04272234629282
143579,2068,4,1,5,M,29.12506792425596
25236,2067,4,0,4,E,29.148202087690045
176647,2067,2,3,5,N,28.76039496633472
31946,2068,2,1,3,J,28.93549847033025
87323,2068,2,0,2,E,28.714101616471545
89773,2067,6,2,8,E,29.38539241865275
88410,2068,7,0,7,P,28.894304471700146
173645,2067,5,0,5,E,29.283797270918264
142888,2067,3,1,4,P,29.386891683039
130268,2068,2,3,5,M,28.936185316434628
93699,2067,4,1,5,J,29.01430591157952
24979,2068,6,1,7,D,28.836198540845444
93072,2067,4,0,4,N,29.36371199883511
82681,2068,2,0,2,A,29.238134930827204
134220,2068,6,0,6,M,29.32715532514996
160431,2068,7,0,7,Q,28.8160162659876
24181,2067,18,3,21,D,29.336801459956547
66625,2068,9,2,11,E,28.400291567672912
116320,2067,1,2,3,J,29.489597743184152
47454,2067,2,1,3,E,29.494347644496997
96944,2068,7,5,12,J,28.8410989436384
54737,2068,4,1,5,J,28.733424103020397
99210,2067,1,3,4,N,29.10333585681072
26749,2067,2,1,3,N,29.08709000836032
101091,2068,2,4,6,J,28.723533889781983
147742,2067,4,2,6,M,28.96629383406949
182017,2067,5,2,7,E,29.544847080922757
16859,2068,6,0,6,N,28.828468486025724
95188,2067,4,3,7,E,29.04916637215447
177161,2067,3,2,5,E,29.177031854102328
86214,2068,3,1,4,P,28.886543808046248
149150,2068,4,2,6,M,28.84786474954392
37662,2067,5,2,7,A,29.162884933762324
87744,2068,2,3,5,J,28.695054892179687
163061,2068,4,3,7,M,28.54270610143445
89639,2067,5,2,7,N,29.117041199011407
74780,2067,5,2,7,D,29.261192021210185
49129,2068,3,0,3,J,28.6307308462996
37045,2067,3,0,3,E,29.30007136527805
148684,2068,3,0,3,K,28.83294435400308
33472,2067,6,2,8,E,29.37502232250012
127898,2067,7,2,9,I,29.2955107624978
64793,2067,4,0,4,K,29.28165693547433
135190,2068,5,1,6,J,29.096125546276795
45178,2068,8,1,9,A,28.53564041299669
51814,2068,1,2,3,K,28.825838488776583
124251,2068,9,1,10,E,29.12845084260543
116353,2068,2,1,3,J,29.253708001045094
73006,2067,7,0,7,P,29.03942621489355
38610,2067,4,1,5,E,29.24720151753361
65735,2068,5,0,5,A,28.78855196505821
56889,2068,2,2,4,J,28.737763541870866
47346,2068,2,1,3,E,28.78261059820941
49433,2067,5,1,6,M,28.89055528975809
44868,2067,3,4,7,P,29.080200113586443
68346,2068,5,4,9,I,28.882737702461597
73697,2067,4,0,4,E,28.97043794881347
92359,2068,4,2,6,E,29.07823379275042
62516,2067,6,2,8,Q,29.41763455759043
166476,2067,6,0,6,Q,29.48458610678241
32300,2067,5,2,7,D,29.064542517459287
50871,2068,4,4,8,N,28.72932653101691
60241,2068,6,2,8,M,28.489229755085237
92903,2068,7,1,8,K,28.65246974854306
130380,2067,6,2,8,E,29.26759730225252
102268,2068,4,0,4,S,28.78172774522847
178341,2067,6,0,6,M,29.147275143739563
109723,2067,4,0,4,M,29.38521172234584
45018,2068,5,2,7,E,29.129945787406783
119616,2068,9,0,9,J,29.122979886525737
54111,2067,3,2,5,E,29.17401297051805
144597,2067,5,1,6,K,29.178073668168047
18922,2068,6,0,6,Q,28.942784315679237
180122,2068,3,0,3,N,28.68176172172671
180608,2067,2,0,2,N,29.30625243794736
164861,2067,4,0,4,N,29.221147167979
134100,2068,4,1,5,M,28.98517858452733
145903,2068,4,3,7,M,28.72341823299528
46141,2068,4,2,6,D,28.53469487144921
146315,2068,6,1,7,M,29.04677271001469
52710,2068,6,0,6,J,28.96259514814261
32647,2068,3,0,3,J,28.65063745154136
181569,2067,4,1,5,Q,29.556544376686908
40210,2067,3,2,5,J,29.266438418337025
69881,2068,12,5,17,E,28.724612104760915
140281,2068,3,3,6,N,28.775817847181496
57150,2068,10,1,11,P,28.734262707761555
53915,2067,3,0,3,J,29.354715820021223
167212,2068,3,2,5,N,29.13489173851073
20504,2068,4,4,8,N,28.833678281182998
167065,2068,4,2,6,M,28.6257671697474
74564,2068,3,2,5,Q,28.95363093308148
98384,2067,25,4,29,E,29.07762938364748
109434,2067,4,1,5,K,29.30875803586086
148870,2068,9,2,11,C,29.091670816712583
52701,2068,5,0,5,P,28.9341379758548
60034,2068,3,0,3,D,28.949761310759104
111306,2067,9,1,10,D,29.226597526021838
140763,2068,2,1,3,E,28.834012438899027
22051,2068,2,1,3,Q,28.917661916203272
141268,2067,7,1,8,P,29.306864733434164
147701,2068,4,0,4,M,28.37728646494069
104540,2067,6,0,6,J,29.25305936801259
124989,2067,2,1,3,K,29.026299767443508
173479,2067,4,0,4,Q,29.458054305946007
36146,2068,4,0,4,N,28.933544663195622
137489,2068,4,0,4,N,28.798391486371344
55421,2068,6,0,6,E,29.19144189061063
33974,2067,3,0,3,M,29.160946356442004
93729,2067,2,2,4,A,29.16303110147025
157176,2068,3,0,3,D,29.01888893051083
144214,2067,6,2,8,E,29.43917806158357
149376,2068,3,2,5,E,28.97335414998788
106905,2068,4,2,6,K,28.889616292540385
132739,2068,2,0,2,R,28.579745985406472
55312,2067,5,2,7,P,29.33282935427031
147904,2067,4,2,6,J,29.27063543702012
68176,2067,5,1,6,N,29.27105913905355
50303,2068,5,2,7,E,28.91010698145315
144597,2068,4,0,4,K,28.76278428279498
129324,2068,7,1,8,J,28.926624559563464
180820,2067,6,1,7,N,29.39362418909256
39288,2067,4,1,5,M,29.67750310217711
62446,2067,6,2,8,J,29.10765749897833
82611,2068,4,1,5,G,28.94303192339393
64279,2067,7,1,8,P,29.1081272664401
108820,2067,2,4,6,J,29.18207333536362
67498,2067,3,1,4,M,29.37685773315568
112958,2067,7,2,9,E,29.058623014885395
124331,2068,4,0,4,E,28.93699454177024
73703,2068,10,1,11,D,28.87422883861024
82435,2068,6,3,9,J,28.87527039997101
53134,2067,4,2,6,M,29.147540245969047
113721,2067,6,0,6,E,29.18750047329244
132324,2068,5,2,7,M,28.594549962504388
46350,2068,3,0,3,N,29.001213738856222
33773,2067,6,2,8,Q,29.087272278175952
64687,2068,1,1,2,M,28.868673138795607
108965,2067,4,5,9,K,29.31745203407975
99435,2067,7,5,12,P,29.28829737913884
147519,2068,7,0,7,Q,28.790214521117058
72057,2067,1,3,4,J,29.3452594060588
149744,2068,6,1,7,A,28.75681402788703
107330,2068,2,2,4,J,29.090598747914264
37824,2067,6,0,6,E,29.045936379736123
150953,2068,4,1,5,M,28.58946716159606
97711,2067,2,0,2,E,29.26427161748981
103968,2067,5,1,6,E,29.361032823934256
125663,2067,4,0,4,E,29.17288872761773
181054,2068,4,0,4,D,29.00536243855309
56650,2067,5,1,6,M,28.806301710072987
176458,2067,5,1,6,N,28.99845752293267
46629,2067,5,1,6,D,28.99943393111762
31034,2068,4,3,7,N,28.730994471839114
146842,2068,3,3,6,M,29.112455008887363
35349,2067,2,2,4,G,29.078050321403843
104260,2068,3,0,3,A,29.2054710446656
33392,2067,9,1,10,J,29.0896467897314
100950,2067,3,2,5,A,29.007893981599928
59724,2067,6,0,6,J,29.323721492174684
145568,2068,5,2,7,M,28.784658666992748
142958,2068,2,0,2,M,28.746109224031223
145343,2067,6,1,7,E,29.19246832344018
128175,2067,3,0,3,E,29.086915355618263
157256,2067,5,0,5,C,29.41392706687324
142157,2068,3,1,4,N,28.82853563431998
133150,2068,3,1,4,E,28.7634727740175
121962,2067,2,1,3,N,29.26030501585805
44484,2067,10,0,10,P,29.444525812964727
125114,2067,3,2,5,E,29.07512087374972
111414,2068,7,1,8,M,28.693164792753123
45026,2068,3,1,4,J,28.845910278466235
69158,2068,4,2,6,N,29.15432926666973
78780,2068,3,1,4,Q,28.8968726986086
41076,2067,5,3,8,A,29.13993716665491
109060,2068,5,2,7,M,28.806891580745138
120689,2067,7,1,8,E,29.109969813797523
29347,2067,5,1,6,I,29.14585477038311
131407,2068,3,2,5,J,28.819631452411706
182103,2067,5,1,6,M,28.941614999432257
78824,2068,6,2,8,M,29.13852077914432
103034,2067,3,1,4,D,28.941975197539243
129574,2068,5,1,6,N,29.06757396634019
133851,2068,4,2,6,M,28.63824029633511
65605,2067,5,1,6,K,28.74555144108434
105412,2068,3,3,6,S,28.922035380076977
159654,2067,3,0,3,E,29.225708001012293
73133,2067,3,2,5,N,29.25201791298119
113479,2068,4,1,5,P,29.033320400712935
60398,2068,4,2,6,D,29.056048995274853
143674,2068,7,1,8,J,28.84833512614301
42125,2068,5,2,7,Q,28.63578366065239
141468,2067,2,1,3,M,29.140205912925868
134409,2068,8,1,9,K,28.521373235859365
24400,2067,4,0,4,N,28.74536303472878
94008,2068,7,2,9,E,29.043015697307727
166682,2067,3,1,4,N,29.55637916325468
57039,2067,4,3,7,Q,29.269524241001537
65001,2067,2,0,2,D,29.11549515047661
146396,2067,5,3,8,M,29.16512071012742
75824,2067,4,3,7,J,29.218990500800142
61252,2068,2,2,4,E,28.934013030581703
22553,2068,6,2,8,Q,28.63314719541405
110886,2067,3,2,5,I,29.463759694659377
116600,2067,3,1,4,E,29.14477439012339
182831,2068,4,2,6,Q,28.79276858936552
147333,2068,4,0,4,S,28.806661635506355
83158,2068,7,1,8,D,28.652722897998004
109303,2068,3,0,3,M,29.06844043686482
156868,2068,3,2,5,P,29.03556318281316
20008,2067,5,0,5,S,29.122230376607902
160343,2067,1,2,3,E,29.2283981203392
126232,2068,2,2,4,J,28.71639117713749
46091,2068,3,3,6,N,28.888246083493456
182671,2068,4,2,6,A,28.86574160096496
131885,2068,2,1,3,E,28.96954303281698
105449,2067,5,2,7,J,29.20198047190216
144088,2067,5,2,7,K,29.083028047689265
37536,2068,6,2,8,P,28.458960008226924
92558,2068,2,2,4,Q,28.797452155745496
150025,2068,1,3,4,M,28.85006205814381
166009,2068,2,4,6,N,28.916041375977283
133146,2068,6,1,7,E,28.607123564683388
111361,2068,5,2,7,M,29.059675568568128
53237,2068,7,0,7,P,28.70904464557772
182986,2068,5,1,6,D,28.972643570392385
133943,2068,7,0,7,J,28.873674115205624
60709,2068,3,1,4,Q,28.547002731092302
59413,2068,7,1,8,N,28.75663539880086
146131,2068,6,1,7,S,29.11478345360736
15823,2068,2,2,4,P,29.114009674711625
23567,2068,5,0,5,A,28.756784758527854
182548,2068,7,2,9,E,28.976815261221077
172037,2068,3,1,4,N,29.09063438416644
70915,2067,4,0,4,N,29.126002564429548
106108,2068,5,2,7,D,29.116429312531384
22040,2067,4,0,4,Q,29.53596738137104
127798,2067,7,4,11,F,29.21310780204963
78786,2068,6,2,8,I,28.726781227600068
62479,2067,3,2,5,E,28.937476711947035
179513,2067,4,1,5,Q,29.054274651543142
165236,2067,1,2,3,P,29.40833041102271
110840,2067,4,2,6,L,29.14010275244222
144774,2068,7,0,7,M,28.860146723811912
122002,2068,4,0,4,P,28.76215893728427
21737,2067,7,0,7,E,29.47696006315758
26061,2067,6,0,6,Q,29.531896751431148
99531,2067,1,3,4,P,29.31834479258879
47985,2068,6,2,8,A,28.683664485289672
24845,2068,6,3,9,J,28.8088443714183
142624,2067,4,0,4,K,29.29814764053129
122516,2067,4,1,5,E,29.2543731307681
30286,2068,4,1,5,K,28.46197724661365
64601,2068,5,1,6,Q,28.826139884353893
45691,2067,2,2,4,A,29.060303982539583
91559,2068,5,0,5,J,28.876589191895864
162791,2068,5,2,7,E,28.86051662737433
172835,2068,4,0,4,Q,28.899766360823094
141940,2068,2,2,4,E,28.54804186767652
134983,2067,2,1,3,E,29.02656439041452
108821,2067,3,0,3,J,29.375342060848027
178580,2067,5,0,5,P,29.424938376495223
45778,2068,5,2,7,F,28.669998895180576
90482,2067,6,2,8,F,29.07791563158226
144507,2067,6,2,8,Q,29.310546187718494
44725,2067,2,1,3,J,29.083642011022956
74650,2068,3,0,3,D,29.097836514018372
102385,2068,2,3,5,N,28.80878195171241
174356,2068,3,1,4,M,29.011085305876257
58918,2068,5,1,6,N,28.96986197392689
163053,2068,4,0,4,J,28.93542716769625
93093,2067,5,1,6,E,29.255223801711416
151053,2068,6,1,7,M,28.948831379340408
147096,2067,7,1,8,M,29.01854519030035
21534,2068,5,0,5,S,28.986609331857053
35741,2068,2,3,5,E,28.94581533991888
17132,2068,4,3,7,P,29.25838749311381
30362,2067,5,1,6,N,29.46131421583709
144457,2068,6,0,6,D,28.983447037618102
21719,2067,6,1,7,P,29.310784887781328
173921,2068,5,0,5,E,29.131539624362293
61752,2068,2,0,2,P,28.51418837440585
121576,2068,7,0,7,M,28.70621808541373
125114,2068,4,1,5,E,28.888905941395084
112443,2067,5,2,7,S,29.55657999639208
91736,2068,9,1,10,N,28.79977467832581
110345,2067,6,2,8,N,29.187124926566465
89680,2068,5,3,8,M,28.78429528393793
146758,2068,7,2,9,E,28.8280151683594
54470,2068,5,3,8,I,28.642957417332283
65214,2067,7,1,8,D,29.156388841244564
91550,2068,1,3,4,D,28.720546494244207
46157,2068,7,0,7,N,28.709836475377408
47272,2067,2,0,2,R,29.03382952679441
146926,2068,3,2,5,E,28.852205771094606
85592,2068,5,0,5,H,28.72677868993936
124428,2068,2,2,4,E,28.96145623659011
99737,2067,4,0,4,E,28.97855755612743
55524,2067,4,3,7,N,28.899205451458634
19083,2067,4,2,6,K,29.33075654251053
131320,2068,2,3,5,S,29.069303762940123
50517,2068,7,2,9,Q,28.831400165727253
98760,2067,6,0,6,N,28.771219579146965
178072,2068,4,2,6,N,28.943848400082864
54598,2068,3,1,4,Q,28.903685885882524
62399,2067,3,2,5,N,29.16860249995
90567,2067,4,0,4,J,29.465777257309067
102752,2068,6,1,7,A,28.849380654274405
102905,2067,3,1,4,P,29.24061312204224
158859,2068,3,3,6,J,28.830525417213565
107613,2067,5,2,7,K,29.215269973670857
76125,2067,1,3,4,N,29.380731694382497
101309,2067,3,3,6,E,28.96937438331853
72773,2068,3,0,3,D,28.986334438718952
76558,2068,4,1,5,E,28.719993462362087
175112,2068,4,2,6,J,28.7648337274513
167373,2068,5,1,6,Q,28.6532338976292
174212,2068,3,1,4,I,28.73325510903681
47993,2067,6,3,9,J,29.157154272849485
143901,2068,4,0,4,P,28.932517103280546
93239,2067,7,1,8,Q,29.413373558009205
100665,2067,2,3,5,E,29.240828461924377
86566,2068,6,0,6,Q,28.589993873816454
34478,2067,5,1,6,E,29.199647841604843
167364,2068,5,2,7,N,29.030182231981858
171262,2068,6,2,8,K,28.713294402331574
27338,2068,2,1,3,N,28.907009599332945
142665,2068,5,0,5,M,28.737872466687776
33274,2067,3,1,4,N,29.40133709243723
106870,2067,4,1,5,J,29.251299548204152
39009,2068,3,0,3,P,28.962348316023423
174261,2068,4,1,5,M,28.74590570960539
149887,2068,4,2,6,M,28.7652358642983
108672,2068,6,0,6,K,28.98759939119065
26367,2068,3,1,4,I,29.00798868833007
16710,2068,2,1,3,D,28.9213908060739
180484,2067,2,2,4,M,28.88477758561637
144997,2067,11,1,12,M,29.10725112123392
121161,2068,6,1,7,N,28.66311898796012
90949,2068,7,2,9,D,29.070549353065378
86041,2067,2,2,4,Q,29.232112126561663
49601,2068,2,1,3,E,28.91956847030303
71812,2067,5,1,6,D,29.11001816343312
82518,2068,5,1,6,D,28.55599551633773
176101,2067,2,2,4,Q,29.50583009355677
55945,2068,7,0,7,Q,28.927967721052863
82773,2068,5,1,6,P,28.70895837067583
164844,2068,4,2,6,P,29.12949142324034
82673,2068,4,2,6,P,28.774279599955808
98252,2067,4,1,5,D,29.00876534968464
76536,2067,5,1,6,N,29.051768262746595
85167,2068,10,2,12,N,28.706757237667727
108652,2067,6,1,7,G,29.35175222044452
66759,2067,6,1,7,N,29.49944793972801
51527,2068,7,3,10,L,29.39219186667356
131208,2068,6,2,8,J,28.564731815721437
81736,2068,4,0,4,N,28.83235205384472
62969,2067,5,0,5,P,29.57966074322727
116643,2068,2,1,3,E,28.54273031016242
106702,2067,4,1,5,F,29.26217199535142
94856,2068,5,1,6,D,28.69591713561505
114716,2067,8,3,11,L,29.42425589476646
124348,2067,7,2,9,P,29.358478307035966
75316,2068,7,0,7,K,29.13207137777248
166221,2068,8,2,10,M,29.109106550109505
56783,2067,2,3,5,M,29.129308594023
36874,2068,5,0,5,M,28.99534540094787
144949,2068,1,2,3,N,28.96124686326507
71807,2068,2,3,5,D,28.85371032987621
75916,2068,6,0,6,J,29.06927535728596
27795,2068,6,2,8,J,28.83969231597417
82321,2067,2,0,2,D,28.975119476061582
150303,2068,5,1,6,P,28.78678592612717
90377,2068,5,2,7,M,28.858268035769605
77845,2068,6,1,7,M,28.97737184428188
98819,2067,10,2,12,E,29.10055569781024
99696,2068,6,2,8,E,29.03354136297691
69607,2068,4,1,5,E,29.261029150670304
165052,2068,6,1,7,E,28.79226868352036
99176,2067,5,3,8,E,29.305496778465088
68206,2067,3,2,5,N,29.25451247898222
83328,2068,4,1,5,Q,28.79825640588288
28016,2067,12,2,14,J,29.270424181171
124995,2067,8,2,10,Q,29.13621093686134
161579,2067,2,2,4,M,29.526341544407806
35349,2068,5,1,6,G,28.73785664095372
174599,2068,8,1,9,J,29.21813414834688
185009,2067,11,2,13,J,29.193809499047344
137126,2067,5,0,5,N,29.43718919990058
22794,2068,5,0,5,Q,29.03106270484207
161481,2067,4,3,7,M,29.172110588891396
59816,2067,1,1,2,E,28.925623749441712
59688,2068,5,1,6,J,29.016786436206143
39109,2067,2,0,2,L,29.07515754725432
100666,2068,5,3,8,J,29.01577179387657
103988,2067,5,1,6,E,29.172439627798592
76648,2067,4,2,6,E,29.295424278551245
145581,2067,5,1,6,E,29.36887523832108
30960,2068,4,0,4,E,29.30335736839869
42417,2068,5,0,5,E,28.634760913392537
148691,2068,4,1,5,M,28.7859592346648
157699,2068,10,2,12,Q,28.890030435483787
113892,2067,5,1,6,Q,29.23695279522517
171072,2067,4,2,6,K,28.96685633430864
145965,2067,2,1,3,Q,29.0100789267153
134984,2067,4,1,5,N,29.14390962119097
122128,2068,4,3,7,E,28.59891669609778
136897,2068,1,1,2,G,28.698701922775143
129546,2067,7,2,9,K,29.026890649217425
178884,2068,1,3,4,P,28.820036612550357
144359,2067,4,2,6,E,29.28881801246486
26568,2067,9,4,13,P,29.22146291005556
135089,2067,4,1,5,N,28.95009131384982
167444,2067,2,0,2,M,28.919555424170163
170880,2068,5,2,7,N,28.97609726874904
128383,2067,4,3,7,M,29.251991863089355
149292,2068,6,2,8,M,28.567361776408923
52656,2068,4,1,5,N,28.796350476659512
28717,2068,3,3,6,D,29.36515898976059
91765,2067,4,3,7,Q,29.384231939116592
92578,2068,4,3,7,Q,29.10497658260765
134474,2067,5,0,5,P,29.195882098349845
143655,2068,4,1,5,M,28.75486383782626
165569,2067,4,1,5,N,28.73018016085712
118954,2067,6,1,7,N,28.866145346778207
75052,2067,11,2,13,Q,28.94743060650391
158633,2067,6,2,8,H,29.44307391035095
146705,2068,7,2,9,Q,28.83555352115955
128009,2067,6,3,9,P,29.266639543413596
114216,2068,3,1,4,K,28.91715461658044
149802,2068,3,1,4,A,28.95248705281981
159785,2067,3,1,4,N,29.011153052315365
75719,2068,2,2,4,F,28.98228619421593
93053,2067,8,1,9,P,29.49535580362425
19068,2068,2,1,3,N,28.882886691153782
97890,2067,2,2,4,N,29.14480017719285
179791,2068,4,2,6,P,28.89318324769542
93782,2067,3,2,5,K,29.129634328787404
165293,2067,2,0,2,M,29.011775778440388
109707,2067,16,2,18,E,29.204079295937703
95700,2068,5,3,8,S,28.659188011122712
68468,2068,5,2,7,E,28.699586462058008
132279,2067,6,2,8,K,28.911899200714124
61971,2068,5,0,5,E,29.20830202375797
66871,2068,5,1,6,N,28.96053708947445
97983,2067,1,3,4,N,28.780856122117772
131860,2067,5,0,5,J,29.026536510248917
40527,2067,5,4,9,M,29.28202146061253
135126,2068,2,0,2,E,28.88629407336336
81639,2068,1,2,3,E,29.05400853050613
47184,2067,2,2,4,N,29.492070252859843
62293,2067,4,1,5,P,29.203040532369645
16801,2067,2,3,5,D,29.364985306278168
140855,2067,3,1,4,M,29.439887566328423
162701,2067,4,0,4,H,29.121413049056567
88196,2067,2,0,2,H,29.17023217167936
174825,2068,9,2,11,I,28.660708927823496
25687,2068,12,1,13,N,28.89529088860472
25726,2067,3,0,3,E,29.199457932447856
32091,2068,7,0,7,Q,28.7366355361856
30227,2067,3,1,4,E,29.188547125752848
105309,2067,2,3,5,J,29.58431752841917
74124,2068,4,3,7,M,29.05529506950876
146533,2068,6,1,7,Q,28.705116650340564
162216,2067,11,3,14,E,28.87497373651143
98812,2068,2,1,3,D,29.079559079353807
140410,2068,6,1,7,E,28.807233232329637
137100,2067,6,3,9,P,29.296359153915347
56749,2068,3,2,5,J,28.74292483633303
120880,2067,3,2,5,E,29.159674251681427
41104,2068,5,3,8,J,29.18148073911341
177671,2067,6,1,7,M,28.918527086025826
143365,2067,6,2,8,N,29.26525596371621
180266,2068,4,1,5,M,28.6189186985962
71363,2067,3,0,3,J,29.51396918359627
182527,2067,3,1,4,M,29.138851566165908
135188,2067,6,0,6,P,29.18768664091
168400,2068,3,2,5,M,28.98968835212862
33728,2067,6,2,8,E,29.16134296659648
140767,2068,4,1,5,D,28.65247128052693
59627,2067,6,2,8,P,29.01743481269015
163487,2067,3,0,3,E,29.349090840422026
130168,2068,5,3,8,N,29.02100866192684
18184,2068,11,3,14,F,28.86577209689665
135024,2067,2,1,3,J,28.812357942809346
88808,2068,1,1,2,Q,28.705031161615903
15897,2068,5,1,6,M,28.966216297604607
143979,2068,5,0,5,F,29.04546132052269
46502,2068,3,2,5,N,28.87750010986648
73090,2068,11,5,16,F,28.754199377150297
158850,2068,6,3,9,Q,28.550541985567392
161457,2068,8,0,8,D,28.726558772323127
134718,2067,7,0,7,E,28.99503414368828
139608,2067,6,2,8,Q,29.070047634535577
157037,2067,3,1,4,J,28.850479165805588
159710,2068,2,2,4,C,29.046331562746804
53563,2067,6,2,8,Q,29.45070582335693
71410,2068,3,0,3,J,28.9152667625886
25958,2068,3,2,5,Q,28.6010357943712
164488,2068,6,0,6,R,28.96440528648757
178256,2067,5,1,6,D,29.141154052064437
158176,2068,7,0,7,E,29.00884829607055
104958,2068,9,2,11,E,28.966663806017763
22852,2068,2,0,2,I,28.97915395089215
116735,2067,6,2,8,E,28.947561449517963
98807,2068,5,0,5,E,28.817407254686668
29201,2068,7,1,8,P,28.8787471973512
93697,2068,5,2,7,K,28.938002438100355
140859,2068,4,2,6,Q,29.06163839675763
47692,2068,4,3,7,P,28.567021478005778
131233,2068,4,3,7,N,28.72965266973343
102115,2067,5,0,5,E,29.29111419740094
31232,2068,5,2,7,J,29.040663280087884
74918,2068,4,2,6,K,28.84994856587187
51626,2067,1,2,3,J,29.249833860489872
116705,2068,5,3,8,E,28.58382340059057
112057,2067,4,2,6,N,29.09111505065713
87293,2067,4,2,6,N,29.163273273101783
166335,2067,3,3,6,J,29.621274884945823
36861,2067,2,0,2,N,29.149652571387755
103159,2067,5,0,5,Q,29.242755156817065
96480,2067,1,2,3,J,29.248239035529483
34243,2068,6,2,8,P,28.900773110725734
104877,2068,5,0,5,N,28.987240063734863
146965,2067,6,0,6,M,29.172269606688975
112442,2068,3,0,3,K,28.95930236534781
177544,2068,2,0,2,P,28.873483058178284
54951,2067,2,0,2,M,29.21579402127072
181977,2067,3,3,6,M,29.24869359170573
148290,2068,3,2,5,M,28.76062458707825
85674,2067,7,0,7,D,29.18447318998657
156993,2068,5,2,7,E,28.884486805543503
106591,2068,3,2,5,K,28.731858669038875
90252,2068,4,0,4,M,28.937671247898248
41200,2067,5,0,5,M,29.057505394389725
159442,2067,6,3,9,N,28.8425354725582
62649,2068,11,4,15,A,28.928682568851663
175334,2068,3,0,3,P,28.73372309609494
169492,2067,4,0,4,P,29.2499163236454
144693,2068,6,2,8,J,28.866386413495093
158978,2067,6,1,7,E,29.30343627108401
129717,2068,8,2,10,J,28.748918848888422
179719,2067,9,1,10,H,29.24156344560476
47907,2067,5,2,7,E,28.79330099468445
132904,2067,3,2,5,J,29.38390801189975
85607,2067,1,1,2,E,29.59771416118632
91999,2068,5,0,5,K,28.699225906634904
60569,2068,5,1,6,Q,28.821777611570663
82773,2067,2,2,4,P,29.21123369041221
86039,2068,2,2,4,N,28.820341230900755
82942,2067,2,3,5,E,29.341739678530303
95682,2067,5,0,5,E,28.95513035066613
129325,2067,6,1,7,D,29.159002489161978
113865,2067,5,0,5,D,29.47931904827533
156943,2067,4,1,5,Q,29.02667686502032
98473,2068,5,1,6,N,28.854181693607465
116736,2068,5,2,7,K,28.70105585427816
140394,2067,6,2,8,M,29.124466559978156
88488,2068,4,1,5,D,28.79984345392222
59288,2068,8,3,11,D,29.00172545651499
169263,2068,6,0,6,Q,29.22388404554708
59294,2068,12,1,13,D,29.048328217845096
112219,2068,3,4,7,S,28.826001711699323
145238,2068,7,1,8,P,28.92717582002341
98428,2068,5,2,7,E,29.06321571587002
134409,2067,5,2,7,K,28.943017323084614
75909,2068,7,2,9,M,28.925327545973754
48984,2068,4,1,5,C,28.893350917657592
135816,2067,6,2,8,M,29.106154165227533
90675,2068,4,1,5,Q,28.74689109854684
156195,2067,3,1,4,N,28.69136219594036
20633,2068,2,1,3,S,28.81459493143456
92308,2068,6,1,7,N,28.977118647313976
132338,2068,3,0,3,P,28.761257094707645
46069,2068,5,1,6,P,28.77770064048449
130506,2068,6,2,8,E,28.82924216428672
51603,2068,6,1,7,E,28.5109794218498
147843,2068,3,0,3,M,28.932171040299067
158866,2067,4,1,5,E,29.179156303202564
162866,2068,6,3,9,N,28.52315044666957
62991,2067,4,1,5,P,29.13394592314776
87598,2068,4,0,4,D,28.672189003627253
166403,2068,6,1,7,F,28.686684773759897
70480,2068,5,3,8,D,28.909951154250475
120845,2068,3,2,5,E,28.67613884190521
157818,2068,1,2,3,K,28.79764344399777
120444,2067,6,2,8,E,29.183594371710644
48589,2067,5,0,5,D,29.08397297284767
145499,2068,9,4,13,P,28.937790398083365
143835,2067,2,1,3,J,29.17668141380178
160910,2067,4,2,6,N,29.287385638675264
108690,2067,2,0,2,J,29.00798079597032
159661,2068,2,0,2,A,28.90966362248971
143579,2067,4,1,5,M,29.1880322299202
129647,2068,7,1,8,P,28.63746583293133
124071,2068,4,1,5,F,28.72124308317857
20445,2067,5,0,5,M,28.89137680835828
171533,2067,4,2,6,Q,29.48824153363061
73304,2068,4,1,5,D,28.77254796696988
114408,2068,4,1,5,K,29.015863368355944
136819,2068,9,2,11,E,28.79825953993973
19733,2068,3,2,5,P,28.94101254171794
131201,2068,2,2,4,J,28.800724324415228
142793,2068,6,2,8,P,28.783030284736277
46941,2068,6,0,6,E,29.217555873310467
170938,2068,5,2,7,S,28.88256319394614
81628,2068,5,1,6,I,29.085877527592896
22492,2067,5,3,8,S,29.00830666128585
126839,2067,4,2,6,J,29.062983020955688
61353,2067,9,2,11,J,29.496144288195087
50883,2067,8,0,8,D,29.10861767816404
86763,2067,6,2,8,D,29.116601709025517
140858,2068,3,1,4,Q,28.96770009875535
165703,2068,6,4,10,I,28.937317225333384
52276,2067,6,2,8,P,29.12948370270897
176584,2067,5,1,6,D,29.287644400824387
55124,2068,7,2,9,E,28.797483950008964
141969,2068,4,3,7,N,28.896158267469637
82309,2068,7,0,7,D,28.94278927239313
140626,2067,2,1,3,D,29.275066455545776
135014,2068,5,2,7,N,28.98751283242142
84544,2068,7,2,9,D,29.05587533596358
46692,2067,9,1,10,R,29.04729679586
162637,2068,2,2,4,P,28.745692507250983
148213,2067,3,0,3,M,29.359259994042187
170672,2068,5,1,6,D,28.47503542711975
84632,2067,5,3,8,D,29.28938207377392
167229,2068,3,3,6,J,28.751697048745168
131973,2067,5,3,8,Q,29.054427225715504
48392,2068,6,0,6,E,28.706023940026675
74837,2067,6,0,6,J,29.02289328006014
84383,2068,5,5,10,S,29.084929671748604
181464,2067,6,2,8,D,29.19259909247792
20584,2068,4,1,5,S,28.863947870639496
20627,2068,5,1,6,J,28.9065075148788
91932,2068,7,1,8,N,28.94439470189544
104883,2067,3,0,3,K,29.187909491168742
41061,2068,3,2,5,E,28.718650712498167
86633,2067,1,2,3,H,29.350413507752247
97729,2067,4,2,6,N,29.245766429807443
139456,2068,4,4,8,N,29.005334960735684
46355,2067,2,2,4,P,29.27327098475052
59422,2067,4,1,5,J,29.13561414454482
78702,2067,7,0,7,M,29.086287395775244
25779,2068,3,0,3,E,28.808175046071906
76016,2067,1,2,3,K,29.17672695139377
89574,2067,2,3,5,N,29.08370978864393
124785,2067,7,3,10,J,29.096905657396263
44481,2068,4,0,4,N,28.57293652251044
99561,2067,5,2,7,J,29.07581559405199
78194,2067,3,0,3,Q,29.054985337469336
81475,2067,5,1,6,D,28.786794141859104
45760,2068,3,1,4,C,28.97409672513597
97868,2067,2,1,3,E,29.199977742097367
163172,2067,4,0,4,M,28.871131702413894
137755,2067,6,1,7,P,29.087602910114867
19163,2067,4,1,5,P,29.083482687946468
162350,2068,6,2,8,E,28.685240348357382
139853,2068,7,1,8,M,28.977247331550103
168140,2068,7,1,8,M,28.78653050605112
53219,2067,2,4,6,S,29.46832075178373
109453,2067,4,0,4,K,29.306734456944888
93656,2068,0,3,3,E,28.692277134687952
131233,2067,3,2,5,N,29.16672440602926
16187,2067,7,0,7,D,28.927430019113245
148103,2068,4,2,6,K,28.785499599485632
108713,2067,5,2,7,M,28.499467496542
112294,2067,3,1,4,N,29.39289595795412
37132,2068,3,3,6,E,28.914676721106375
52564,2067,6,3,9,Q,29.309457383354825
47042,2068,2,0,2,Q,28.704806224923335
128450,2068,4,2,6,M,28.62326352722696
41241,2068,7,0,7,I,29.027925262835293
102012,2067,3,3,6,J,29.517301848747767
15851,2068,14,3,17,A,28.95866815889624
147231,2068,5,1,6,M,28.854096894668054
82422,2068,3,3,6,Q,28.85701338924316
76408,2068,6,2,8,E,29.26380851333144
173595,2067,5,0,5,J,29.03173209465549
164097,2067,3,0,3,N,28.907284074486792
107064,2067,5,0,5,N,29.28585451993349
117252,2067,2,0,2,E,29.24836413339937
129557,2067,2,0,2,S,29.252294644603666
74224,2068,11,2,13,D,28.71499394470081
100157,2068,4,3,7,N,29.224883878854957
113699,2067,2,2,4,N,29.19766159579063
124204,2068,3,1,4,P,28.966248218609877
31088,2068,5,0,5,R,28.95027510642762
108568,2068,6,1,7,E,29.024537049231203
109133,2067,6,1,7,F,29.19449468495833
147612,2067,6,3,9,D,28.99651207167005
44947,2068,2,1,3,J,28.7907982440902
45451,2067,6,4,10,J,28.91345529129708
144747,2067,7,2,9,M,29.40022634751395
150114,2068,7,0,7,M,28.86874017020565
161073,2068,2,1,3,E,29.02262207884084
147681,2067,6,1,7,E,29.118736478098825
147523,2067,6,2,8,P,29.372239035950635
31203,2067,2,1,3,E,29.125073646654776
34522,2068,4,2,6,M,29.052036654248
180436,2067,6,1,7,M,29.369918079098973
88031,2068,5,0,5,P,28.80458228379788
119847,2067,10,0,10,E,29.001031036937555
89822,2068,3,4,7,D,28.80170612835645
38130,2067,4,2,6,S,29.66385667527337
135844,2068,3,0,3,M,28.81406958029818
59878,2068,2,3,5,E,28.868900222163106
35741,2067,5,2,7,E,28.89151123714876
131625,2068,5,2,7,M,28.87418650745836
176308,2068,5,0,5,K,28.9001255190996
137015,2068,3,2,5,J,28.85338094888988
161467,2068,3,2,5,N,28.813069848555987
138892,2067,4,0,4,P,29.470555669748418
163461,2068,7,1,8,P,28.693837441199623
125669,2067,4,0,4,R,29.28645683741114
67052,2067,4,2,6,D,28.98679029536861
106894,2068,3,4,7,E,28.75984402113994
117210,2067,5,2,7,N,29.308473163931243
94550,2067,2,1,3,M,29.04879459957904
32920,2068,6,1,7,E,28.747552529714515
27779,2067,6,2,8,N,29.32567627222928
141659,2067,4,0,4,P,29.021013061023574
30561,2068,9,1,10,P,28.950366454832466
99731,2068,20,7,27,E,28.88272297338874
49477,2068,6,3,9,A,28.679021897384352
102891,2068,4,5,9,S,28.658194303348168
118103,2068,2,0,2,N,28.89491693827444
65892,2067,4,0,4,E,29.05197353133656
105086,2067,3,1,4,E,29.10212595841963
73295,2068,5,0,5,E,28.635779624175544
167268,2067,6,0,6,N,29.418308282355948
73885,2068,2,1,3,E,28.60148520756569
82764,2068,1,1,2,C,28.85829608359428
147876,2067,4,2,6,N,29.330287036259524
116176,2068,11,2,13,L,28.752581159193934
19651,2067,2,0,2,E,29.140245024220743
148889,2068,4,2,6,M,28.492475232829683
157680,2067,1,3,4,A,29.02944645616507
108688,2067,9,2,11,E,29.4109707004448
72826,2067,5,0,5,M,29.09187247033824
140241,2067,4,0,4,P,28.892726498116847
120750,2067,5,0,5,E,29.050433738652995
147106,2067,5,2,7,E,29.03726824173995
120455,2068,5,3,8,E,28.930450803139102
54390,2067,7,1,8,E,28.75425862001069
109935,2068,5,3,8,S,28.85146763272964
93976,2068,5,0,5,N,29.151439968832623
26557,2067,3,2,5,A,29.125135432294996
60122,2067,3,1,4,M,29.088113507944563
165657,2067,3,0,3,S,29.070877444254307
135501,2068,5,1,6,J,28.748370043069396
66125,2067,6,2,8,J,29.377296413063856
94885,2067,5,0,5,J,29.151657471059487
42282,2068,4,2,6,G,29.20450543801198
89145,2068,4,1,5,S,28.793447662171623
103135,2068,8,4,12,Q,28.78471751084443
59806,2068,2,1,3,N,28.69893070046965
147261,2067,3,1,4,M,29.244262601703152
92049,2068,10,2,12,N,29.13604616450721
30237,2067,1,2,3,J,29.328823297955537
143678,2068,4,0,4,M,28.742514625374277
46076,2067,1,3,4,Q,29.3267112705217
104284,2067,8,0,8,E,29.323897153833187
158168,2068,4,1,5,N,29.134996364510464
45518,2067,19,3,22,A,29.539690709764248
123195,2067,7,0,7,P,29.20747409289265
38707,2068,4,3,7,M,28.9938034199505
180701,2068,7,0,7,Q,28.52642432863573
135610,2068,4,0,4,K,28.652585528231363
175402,2068,14,3,17,Q,29.05186430622817
41473,2067,4,0,4,N,28.842250530919284
76753,2067,5,3,8,N,28.86326149667576
143842,2068,5,1,6,P,29.00417713871421
127498,2068,7,2,9,E,28.792926641070096
69459,2067,1,2,3,E,28.969741944582115
143092,2067,4,2,6,Q,29.39683591465035
175291,2068,8,4,12,Q,28.906914893055827
125520,2068,7,3,10,A,28.922912548434127
144646,2068,2,1,3,M,28.54491637876752
175832,2067,2,2,4,M,29.21150827537566
102752,2067,5,0,5,A,29.266666821471144
67347,2067,6,2,8,N,29.358267208676025
120086,2067,5,1,6,C,29.34333194597199
86972,2067,3,1,4,S,29.13198321484192
158061,2067,0,3,3,N,28.977581291579504
142523,2068,3,1,4,P,28.717065926240213
98075,2067,6,3,9,Q,29.366313766683973
144387,2067,6,2,8,E,29.373532684132964
78109,2068,5,2,7,R,28.91800039842151
52210,2068,7,1,8,N,28.718265989345912
115373,2067,6,2,8,E,29.234602815423127
74371,2067,5,3,8,D,29.146182507452195
46941,2067,4,0,4,E,29.31343823907105
95682,2068,2,1,3,E,28.585150213701564
129100,2068,6,1,7,N,28.72353458023229
17706,2067,3,2,5,N,29.278437531931505
84195,2068,2,3,5,N,28.55404491566373
171530,2067,2,0,2,J,29.398781577784035
114212,2068,7,0,7,E,29.04388324046399
55240,2068,6,1,7,Q,28.997877178305743
116067,2068,1,1,2,K,28.98783499827014
115057,2067,4,2,6,J,28.98087355668632
139031,2067,3,0,3,M,29.03126005343336
47899,2068,6,2,8,N,28.942541989292582
93925,2068,3,0,3,N,28.90842514022187
119009,2068,4,1,5,P,29.23231845561025
108291,2067,6,0,6,J,29.21503063120949
102246,2067,4,2,6,E,28.86548269624193
41184,2068,7,0,7,P,28.9692608988731
150910,2068,4,0,4,M,28.772036851190403
143655,2067,6,2,8,M,28.74089496544654
48880,2068,3,2,5,S,29.008543828227246
25035,2067,7,0,7,D,29.299145124028964
170854,2068,5,2,7,P,28.513072635562235
147041,2067,6,1,7,M,29.37700242780228
167955,2067,9,3,12,J,29.366076075536807
157326,2068,2,2,4,J,28.80559026717923
68640,2067,2,3,5,K,29.45594534064895
166996,2067,5,2,7,Q,29.20698982636433
58823,2067,6,0,6,N,29.324410475598945
121617,2067,5,2,7,E,29.353395690380548
102407,2068,3,4,7,K,28.81379252805173
96764,2068,4,4,8,J,28.92387724666465
89753,2068,3,1,4,N,28.7829850511223
115626,2068,6,0,6,N,28.99341938405605
147737,2068,7,1,8,M,28.71663024272108
72070,2068,5,1,6,E,28.686065246064494
24969,2068,4,1,5,J,29.084739661849028
45691,2068,3,2,5,A,28.711594112192607
86571,2068,4,1,5,G,29.22909039381683
27989,2068,6,1,7,K,28.5935701493379
78311,2067,1,4,5,L,29.09306590202495
182587,2067,1,2,3,Q,29.159135125351632
128547,2068,4,2,6,P,28.609985629792245
138131,2068,3,0,3,Q,29.037625628028948
166955,2067,6,1,7,N,29.19323844425171
181317,2067,5,2,7,D,29.181361207548186
136355,2068,7,2,9,E,28.93029079020748
149573,2068,4,0,4,M,28.91878842066033
108985,2067,5,4,9,E,28.771377902559525
34558,2067,7,2,9,D,29.163280967268435
83630,2067,4,1,5,A,28.90610846516369
50325,2068,5,1,6,J,28.413088855595365
138524,2068,6,2,8,J,29.26789652516697
140038,2067,2,3,5,P,28.969437196799007
77804,2068,7,2,9,M,29.059040972637224
162084,2068,1,1,2,P,28.861397376220904
146876,2067,4,0,4,M,29.081310936842247
61865,2068,2,2,4,J,29.07532939589924
116186,2067,5,1,6,P,29.235427877331187
57405,2068,6,2,8,M,29.17409508360951
138212,2067,4,1,5,N,29.34139052662708
19549,2068,5,2,7,J,28.662439117010475
133147,2068,5,1,6,E,28.626388042768355
113980,2068,3,2,5,N,28.86580513913414
175840,2068,1,2,3,N,28.745526843160107
90884,2068,6,3,9,S,29.39897940324532
105311,2068,2,2,4,M,28.740942310008037
144958,2067,5,2,7,M,29.16716321437246
164874,2068,3,2,5,D,28.782607400655447
108391,2068,9,3,12,F,28.7741986716367
103241,2067,3,3,6,N,29.15108483464944
119410,2067,9,4,13,C,29.02599580560938
47572,2067,6,1,7,J,29.01113306938492
47904,2067,1,4,5,N,29.11563345727364
139184,2068,5,0,5,J,29.484146222522536
74036,2068,6,1,7,N,28.78537943228654
157010,2068,7,2,9,A,28.76692880560621
30726,2068,7,1,8,D,28.85140006438373
131155,2068,7,5,12,P,28.366915486080217
53108,2068,4,2,6,D,29.02695811105793
87724,2067,5,2,7,C,29.460105288136173
117073,2067,6,1,7,J,29.068354420653424
144308,2068,3,1,4,M,28.871177149248
93479,2068,6,1,7,J,29.12410376404549
178711,2068,6,1,7,I,28.82621571327294
46032,2067,2,0,2,Q,29.27240795772761
29935,2068,12,0,12,Q,28.87665459389363
179099,2068,6,2,8,Q,28.940231281009176
37903,2068,5,2,7,E,28.87168511891821
119651,2068,3,2,5,N,28.615946300307925
82907,2067,3,2,5,D,29.260365275512736
160753,2067,5,3,8,N,29.586786148769765
115624,2068,3,3,6,E,28.718748635336635
61115,2068,5,2,7,N,28.918627023230567
102169,2067,8,9,17,P,29.20169888855971
140459,2068,5,3,8,Q,28.903949698052816
53525,2067,1,2,3,S,29.0589237454103
23810,2067,8,1,9,A,29.0353169285034
147891,2067,5,3,8,N,29.48893699176984
137082,2068,3,0,3,N,28.79558430684993
119566,2068,5,2,7,S,29.22144058163836
50771,2068,9,1,10,A,28.650593225353138
173288,2067,6,1,7,L,29.20799297580433
103032,2068,5,0,5,E,28.568560925517957
44738,2068,7,7,14,I,29.111460756836056
120609,2068,6,1,7,J,29.109073613839723
98636,2068,6,1,7,J,28.78481474354543
107571,2068,6,0,6,E,29.01770890990113
52380,2068,4,4,8,P,28.463778654658448
158546,2068,6,2,8,Q,28.817750547944733
148901,2068,9,3,12,J,29.03611638752953
137370,2067,2,1,3,E,29.12646277111739
171793,2068,3,3,6,Q,29.100725444850664
36326,2067,6,1,7,A,29.234800839192697
86046,2068,3,1,4,E,29.0417393080252
92596,2068,3,3,6,J,29.094939580617545
151074,2068,6,1,7,M,28.88999550689431
28321,2067,3,1,4,M,29.004023908041614
70001,2068,31,7,38,E,28.931554381977783
40242,2067,3,0,3,Q,29.183253862452226
87849,2068,7,0,7,K,29.241800347011303
16925,2068,2,0,2,N,28.56686902556001
108533,2068,5,1,6,K,28.83781821860161
134022,2068,4,0,4,M,28.69867010000711
24326,2067,6,2,8,N,29.259019159592047
60087,2068,4,0,4,E,28.77012497079796
97183,2067,2,0,2,N,29.02250025775164
88278,2068,5,2,7,K,29.06654599441895
77034,2067,2,2,4,N,29.166194979540187
160428,2067,5,2,7,S,29.086215493415654
87655,2067,5,3,8,K,29.328338920572637
146712,2067,6,2,8,P,29.043680729667347
50174,2067,4,1,5,P,29.12794053611611
48794,2067,3,2,5,K,29.27191268453125
183080,2068,4,2,6,N,28.96924741294737
71569,2068,6,1,7,Q,29.055967153509744
59776,2068,6,2,8,D,28.474851762740144
108893,2068,4,2,6,K,28.60553411480134
95442,2067,5,2,7,N,29.00956863661736
130559,2068,6,0,6,J,28.96358624713261
79426,2068,7,1,8,P,28.799535587576965
82131,2068,2,2,4,N,28.879664534410505
148870,2067,2,1,3,C,29.187013097828927
28310,2067,5,1,6,Q,29.30270902544636
122120,2067,5,2,7,Q,29.440147116519267
162598,2068,2,1,3,F,28.80058237580832
145768,2068,7,2,9,M,28.920062452051702
94187,2067,6,6,12,C,29.599768428062625
127579,2068,5,3,8,Q,28.62028679781509
177474,2068,4,1,5,E,28.681557367178307
41794,2067,4,1,5,M,29.004171047335348
49580,2067,5,0,5,K,29.26500707054717
109768,2067,5,1,6,E,29.311134445484075
160726,2068,4,1,5,N,28.4173581504138
94139,2067,2,2,4,M,29.58446677421765
143153,2067,3,1,4,M,29.26846801409738
66451,2068,3,2,5,D,28.97006220164273
54937,2067,4,1,5,Q,29.24224215665346
135847,2067,7,0,7,M,28.978785864612234
19406,2068,8,1,9,D,28.87379856169066
146815,2068,5,2,7,M,28.87847359108172
36144,2068,6,1,7,N,28.672915292581614
134764,2068,6,2,8,L,28.67613340221073
135267,2067,8,1,9,P,29.303177315860797
158648,2067,4,2,6,Q,29.20534789940776
55352,2067,5,2,7,Q,29.05854434668491
167953,2068,4,1,5,M,29.00582892104805
118032,2068,4,0,4,E,28.70033678845568
98315,2068,4,2,6,S,28.78691846953265
130558,2067,3,3,6,Q,29.18159665869982
58740,2067,7,2,9,E,29.04851058411162
125669,2068,4,2,6,R,28.90589461477346
84256,2068,4,2,6,E,28.615178158772107
170594,2067,2,0,2,J,29.381816152048334
111691,2068,5,3,8,K,28.74548661325649
49024,2067,4,2,6,J,29.132398517212906
137491,2068,3,0,3,N,29.02196838636352
145971,2068,4,1,5,K,28.67744178894574
142287,2068,8,0,8,E,28.95509540581494
138527,2068,2,0,2,N,28.95086672997732
97102,2067,5,1,6,E,29.013931934690824
145885,2068,6,0,6,J,28.639278160999154
21481,2067,6,2,8,Q,29.440925755579368
62343,2067,5,2,7,D,29.32418415214796
110249,2068,4,3,7,N,28.60525375928528
120831,2067,4,7,11,E,29.073881079480486
102069,2068,4,5,9,E,28.565338984844875
63001,2067,5,2,7,K,29.211447483377555
44641,2068,4,2,6,E,28.57105932094454
170529,2068,5,2,7,Q,29.01293947118065
88814,2067,3,1,4,N,29.281261830068768
123534,2067,4,1,5,D,29.4175465479966
105130,2068,6,2,8,E,28.704027022138497
117639,2068,5,0,5,K,29.019273690708477
178667,2068,7,0,7,D,29.106938485191243
28093,2068,1,1,2,E,28.864849705409057
178559,2067,7,0,7,P,29.523275634975647
161013,2068,6,2,8,K,28.984656642351982
62187,2067,4,3,7,Q,29.48418793629224
108106,2068,6,1,7,J,28.779943244802475
104870,2067,5,0,5,P,29.12663566322844
17045,2067,10,4,14,A,29.153906452135743
169686,2067,3,0,3,Q,29.414957367677257
148568,2067,7,1,8,M,29.138757438158702
163463,2068,7,4,11,P,28.797887922601365
25883,2067,5,1,6,Q,29.27886671693329
101958,2068,2,2,4,I,28.938368025721086
76775,2067,2,3,5,E,29.319961500509297
136533,2068,5,1,6,M,28.824294765847124
133504,2068,2,2,4,N,28.983768209643564
74541,2068,4,0,4,M,28.8187958276212
54684,2067,2,0,2,Q,28.968870452183697
16259,2067,2,1,3,S,29.07665765513774
95887,2068,2,3,5,P,28.771145743013424
106313,2067,4,1,5,M,29.326443524285043
113706,2068,2,2,4,K,28.624471494567874
22682,2068,7,2,9,A,28.726866554440857
20118,2067,6,2,8,E,29.391385529952004
82831,2068,4,2,6,J,29.02376920800893
33085,2067,3,2,5,E,29.460868265383446
114700,2068,4,2,6,E,28.948509306218416
65744,2067,1,1,2,N,29.48677123319988
64124,2068,6,0,6,N,28.556862535507225
46590,2067,3,3,6,D,29.41008152860249
136879,2067,3,1,4,P,29.3377553663996
28059,2067,3,1,4,D,29.123798031573543
135662,2068,4,1,5,J,28.56336838974391
32414,2067,2,0,2,Q,29.276553811596457
16628,2068,1,2,3,E,29.04509320078915
164862,2067,4,1,5,D,29.150329832512227
131478,2068,7,0,7,N,28.785978282740857
24385,2068,5,1,6,P,28.944939236250708
53344,2068,2,0,2,E,29.16806320993372
17443,2068,2,0,2,P,28.602479548033696
79213,2068,6,3,9,P,28.793943470986694
104422,2068,6,2,8,E,28.79278574952288
137715,2067,5,1,6,Q,29.173327993480715
172145,2067,2,3,5,R,29.1651984438982
104603,2068,3,0,3,K,28.83715458511464
99475,2068,6,1,7,P,28.827578981102448
39805,2068,7,1,8,N,28.85100979029348
110840,2068,4,1,5,L,28.88046559676969
135376,2067,6,2,8,M,29.192210072844247
96761,2068,7,1,8,E,28.617925692080696
114190,2067,7,2,9,J,29.22939894508696
144994,2067,2,2,4,M,29.71738956703335
20126,2067,4,1,5,J,29.301854839541697
105907,2067,3,0,3,P,29.257966967426206
56692,2068,5,2,7,P,28.60818981605695
87940,2067,4,0,4,P,29.09221688525852
128915,2068,6,0,6,Q,28.537549742311796
61181,2068,5,1,6,N,28.52487624012805
109214,2067,3,3,6,S,29.43066773149733
55194,2067,5,2,7,M,29.014277777343818
60550,2067,2,2,4,Q,29.16512130509737
87014,2067,6,0,6,N,28.935097201659275
33395,2068,6,2,8,K,29.104256006501632
114245,2068,6,0,6,E,28.88978336175845
145839,2068,4,2,6,M,28.90494169077365
170673,2067,5,2,7,M,29.245738777138367
51616,2068,4,2,6,Q,29.09721449447642
66866,2068,10,3,13,E,28.578826287702277
144387,2068,5,1,6,E,28.88344757684779
63263,2067,2,3,5,S,29.28102194403261
182369,2067,6,1,7,K,29.066952895778
130420,2067,5,0,5,C,28.908737891367576
76767,2067,4,1,5,M,28.87981413395073
119556,2067,2,1,3,H,29.276211110532056
61645,2068,10,5,15,C,28.982078259790136
97354,2068,3,2,5,E,28.891059621570847
166503,2067,5,0,5,P,28.92457411251467
148883,2067,3,1,4,P,29.00835314683301
76399,2067,5,2,7,N,29.114135846505548
176582,2067,4,2,6,N,29.292536677896543
169776,2068,7,0,7,E,28.954118708728995
167953,2067,4,1,5,M,29.25103835907124
179064,2068,9,0,9,N,28.6160227821638
118486,2068,9,4,13,K,29.00738488255643
132325,2068,5,1,6,H,28.632049604802937
170293,2067,3,2,5,Q,29.354068110012943
120810,2068,5,2,7,J,29.16643168953878
174571,2067,6,2,8,R,29.551702152950075
84522,2067,6,0,6,P,28.96076684795978
146023,2068,5,3,8,J,28.87722532126064
134718,2068,3,0,3,E,28.997023210532696
133927,2067,6,0,6,N,29.06863249196333
81430,2067,4,2,6,Q,29.21502506061676
75260,2068,1,1,2,K,28.79860266716952
148152,2067,5,1,6,P,29.018083467645575
38583,2068,10,2,12,J,29.062662016955137
71609,2068,4,2,6,J,28.71791584623894
161657,2067,6,2,8,P,28.900180891047043
110693,2068,5,3,8,S,29.124553354133475
182287,2068,5,2,7,K,28.634543676704936
161628,2067,3,3,6,M,29.21226744180569
85621,2067,6,2,8,S,29.04925059321119
68548,2068,4,1,5,E,28.61222993926721
76147,2067,3,0,3,A,29.36028505982901
20318,2067,4,1,5,N,29.28533146873341
51141,2068,3,3,6,N,28.843279374249864
136897,2067,2,3,5,G,29.09499315488593
36344,2068,6,1,7,E,28.670851484440742
72453,2067,2,2,4,E,29.140867515297412
48589,2068,7,1,8,D,28.86028763776392
166420,2067,1,2,3,M,29.51104440655939
18760,2067,3,1,4,K,28.962593364972467
113078,2068,5,4,9,J,28.77310681546024
121882,2067,7,4,11,M,29.281541828906736
179950,2067,4,3,7,P,29.237946332787978
68952,2068,6,0,6,E,28.72000646636603
87090,2067,6,1,7,E,29.167412901475064
73912,2067,3,1,4,K,29.272272519450915
147106,2068,6,2,8,E,28.88391611917916
46076,2068,5,1,6,Q,28.743219923535776
65444,2067,5,0,5,N,29.2315842971041
148384,2068,7,0,7,M,28.749823862870425
20196,2067,6,1,7,N,29.06516738691868
89334,2068,3,2,5,M,28.696533954839577
110229,2068,3,1,4,E,28.814693281685813
87936,2067,6,1,7,P,29.038992261005912
176942,2067,3,2,5,R,29.27564635350916
141936,2067,8,2,10,Q,29.15140199916269
50981,2067,4,2,6,K,29.38748935213181
66153,2068,9,3,12,E,28.75898080973373
69890,2068,3,1,4,J,28.71043402950962
26058,2068,4,0,4,Q,28.850067230566463
125682,2067,3,1,4,J,29.034853808718143
156610,2068,2,3,5,N,28.757015281291693
175538,2067,3,0,3,M,29.131901070306643
176969,2067,2,0,2,E,29.255623620144732
93604,2068,2,2,4,D,28.60038945588248
159081,2068,6,0,6,J,28.86429542327624
116525,2068,4,1,5,M,29.06855170380405
25268,2068,1,2,3,E,28.87472982089064
113637,2068,7,0,7,J,28.572353573822458
78365,2067,6,1,7,A,29.021412616382975
92309,2067,2,2,4,K,29.00169954184901
74021,2068,4,2,6,E,28.909390449782165
127481,2068,6,0,6,K,28.94888165650844
87742,2068,5,2,7,J,28.874813747868966
21196,2067,6,3,9,P,29.07256420592276
160909,2068,5,0,5,J,28.949980796021176
107226,2068,5,2,7,N,28.92229909860953
138508,2067,7,1,8,P,29.14335488923259
120260,2067,5,1,6,S,29.223527907599507
33052,2067,7,2,9,E,29.343350977357467
145221,2068,10,3,13,F,28.739684489376604
140225,2067,3,1,4,J,29.16155919799094
75011,2068,4,2,6,G,28.75915537731296
97762,2067,6,2,8,Q,29.120435905084367
93444,2068,6,5,11,E,28.93246247799633
148383,2067,5,2,7,J,29.24932966954592
109480,2068,8,6,14,Q,29.04565393123826
27583,2068,4,2,6,K,28.56590800035067
36361,2068,6,1,7,M,28.70922088871091
145287,2068,6,2,8,P,29.01736359741617
65382,2068,3,1,4,M,28.984524506573692
156737,2067,6,2,8,E,29.01362781738418
56876,2067,3,1,4,E,29.335911677503304
18141,2068,8,1,9,I,28.547183434142013
96650,2068,2,1,3,Q,29.09395949626002
59210,2067,5,2,7,D,28.976653220954034
162699,2068,2,3,5,S,28.523525254252267
69800,2068,2,0,2,E,28.810856471952587
146006,2067,6,1,7,E,29.18501728063012
28543,2068,7,0,7,D,28.75766999891796
137436,2067,2,2,4,J,29.35420756964187
24326,2068,6,1,7,N,28.835091546419434
17255,2067,1,1,2,S,29.342969417824214
37271,2067,4,3,7,J,29.23244101902488
170219,2067,9,2,11,E,29.13177765964764
34429,2067,5,2,7,S,29.40832955064631
31394,2067,9,1,10,D,29.15751060883073
58922,2067,4,2,6,J,28.995352939399098
97832,2068,4,1,5,N,28.85144532688762
63140,2068,6,0,6,J,28.717295603612868
49376,2068,5,2,7,D,29.11366654171493
105343,2067,4,3,7,N,29.482883024957143
176705,2068,3,3,6,J,28.727791362070796
134678,2068,3,6,9,I,28.8238338040422
146892,2067,6,1,7,M,29.058378331629957
53215,2068,4,1,5,P,28.762815494059595
75679,2067,3,2,5,K,29.042268366758325
141135,2067,2,0,2,K,29.19093693213286
28175,2067,4,2,6,E,29.12380334320808
99802,2067,7,2,9,E,29.254497789782462
48508,2068,3,0,3,K,28.82027125610858
148830,2068,7,2,9,E,28.43428708213087
89188,2068,6,1,7,D,28.9274930055146
66120,2067,4,2,6,J,29.396589495500372
106596,2067,14,6,20,H,29.20778024593488
16499,2068,5,2,7,Q,28.359555088608595
109802,2067,4,1,5,N,29.25401156315479
91732,2067,4,2,6,A,29.177284101062288
102608,2067,5,2,7,N,29.331977923025445
53063,2068,5,1,6,E,28.720270530037013
176324,2067,6,1,7,N,29.31488422667802
147134,2068,5,1,6,M,28.697687308680624
133675,2068,2,1,3,N,28.686705379249144
32098,2067,4,1,5,D,29.101222666169548
78975,2068,7,2,9,M,28.840771025421656
83569,2067,4,1,5,E,29.231470639336116
147519,2067,5,0,5,Q,29.346844740301854
63972,2067,6,2,8,D,29.073542026190744
83883,2067,6,2,8,N,29.19721908744351
23994,2068,10,1,11,Q,28.52838015128097
174007,2068,4,1,5,P,28.82246860348948
66436,2067,5,2,7,Q,29.210365758409463
56689,2067,3,0,3,K,29.240580080987844
25313,2067,6,0,6,D,29.38292317934101
92855,2068,3,2,5,E,29.08026071871833
150818,2068,2,2,4,M,28.99865514620062
181944,2067,2,1,3,E,29.46434212449386
177101,2068,4,3,7,E,28.673075182814756
94317,2067,4,3,7,N,29.30744597246536
42165,2068,4,3,7,E,28.87395901639464
66845,2067,3,1,4,E,29.27264107683993
64878,2068,5,2,7,A,29.067968798214523
64801,2067,4,0,4,M,29.22797111475257
50795,2068,4,0,4,S,29.17323883644353
121931,2067,3,1,4,N,29.101418054121687
140504,2068,2,2,4,E,28.49276710674444
117129,2068,4,0,4,R,29.15090870705409
106873,2068,10,3,13,P,28.819294563120483
135282,2068,2,1,3,D,28.778980644829765
135114,2067,6,1,7,A,28.789918023503123
144270,2067,4,0,4,D,29.130477311885222
108128,2067,3,0,3,E,29.45366184588606
31903,2067,3,3,6,M,29.40855578812701
136241,2067,2,2,4,P,29.02842369972062
136626,2067,5,2,7,M,29.22287435926101
44695,2068,10,1,11,A,28.99939489369765
78138,2067,6,2,8,J,29.110483703734555
109996,2067,6,1,7,J,29.264340088788597
148721,2068,4,2,6,Q,28.86381180138658
109282,2067,2,1,3,J,29.071639464001517
28568,2067,2,3,5,N,28.76038516473982
22694,2068,5,0,5,M,28.724126017535653
149775,2068,7,1,8,M,28.97920917109407
67192,2067,6,2,8,J,29.11461359786149
59864,2067,4,1,5,Q,28.768869493971525
137994,2068,6,2,8,J,28.949964199425107
165732,2068,3,1,4,M,28.82774129186936
54034,2068,6,1,7,H,28.750549718428363
156096,2068,4,3,7,A,28.566844320862696
120197,2067,6,3,9,E,28.83627334322518
75603,2068,4,2,6,Q,28.63000564087314
119385,2067,7,2,9,P,29.284403495904947
57603,2068,5,1,6,S,28.971700620072717
170883,2067,6,0,6,E,29.31169800737424
95307,2068,4,1,5,E,29.10746634609855
74883,2068,9,0,9,N,29.20565565508641
90633,2068,6,1,7,M,28.940713391133126
16958,2068,5,0,5,E,28.840147300518257
16533,2068,1,3,4,A,28.89915670475945
132007,2068,3,0,3,J,28.788084534108663
76154,2067,5,0,5,E,29.108002984220796
158760,2068,4,2,6,N,29.2439584103702
159393,2068,4,0,4,Q,28.632443383123636
185012,2067,5,2,7,P,28.9164113877381
175760,2068,3,2,5,E,28.85390170887969
103673,2067,2,1,3,R,29.19258557495616
178874,2067,6,0,6,N,29.20372747632849
128895,2068,3,0,3,K,28.766280573636998
59362,2068,4,4,8,N,28.952001000900303
59143,2067,3,1,4,D,29.10740632866748
147422,2068,5,0,5,J,28.760862714659083
172883,2067,3,0,3,N,28.92141126617084
53554,2068,3,2,5,P,29.01502131955316
119594,2068,4,1,5,N,29.11045595754002
25518,2067,5,2,7,N,29.002983909210727
82906,2067,5,0,5,Q,29.538894407227943
89048,2067,1,2,3,Q,29.226891305520137
46567,2068,2,3,5,A,28.947628590373785
127345,2067,5,1,6,J,29.093184301569128
20980,2067,3,2,5,N,29.20066540701944
157753,2068,2,2,4,M,28.757914247995195
54461,2068,4,1,5,J,28.92193086290577
26175,2067,5,0,5,A,29.12459206636094
131407,2067,6,0,6,J,29.03420781770468
17551,2067,5,0,5,D,29.177212599309517
77926,2067,3,0,3,Q,29.106277810986168
36383,2068,3,1,4,Q,29.11795290468379
73579,2067,6,2,8,D,29.66798028927937
55080,2068,5,3,8,E,28.70732216901782
82410,2068,6,0,6,E,28.68225442872061
16688,2067,2,0,2,P,29.340772708692388
132047,2067,7,3,10,K,29.128526391261502
125047,2068,4,3,7,P,28.720210694988708
139424,2068,6,0,6,H,28.849013780634014
17139,2067,5,1,6,D,29.29809022624117
147383,2067,3,2,5,A,29.70603688998102
49004,2068,4,2,6,J,28.712316630649813
32607,2067,3,2,5,Q,29.058457142657105
88155,2067,7,2,9,E,29.38077191556736
69651,2067,8,0,8,D,28.82690177107556
89600,2067,7,2,9,N,29.07365427036268
114638,2067,6,0,6,M,28.953793496953576
101727,2067,5,0,5,J,29.36930139614651
62149,2068,1,1,2,P,28.716764403093947
27793,2068,6,2,8,J,29.02476744100465
125123,2068,6,2,8,K,28.981302396081404
133056,2067,6,1,7,P,29.532512640176364
175354,2067,5,2,7,R,28.760619305220303
174250,2068,2,2,4,J,29.00750729648623
72453,2068,3,1,4,E,28.991970600478
167807,2068,6,0,6,N,28.83782832004852
17904,2067,3,2,5,J,29.23219686748988
101743,2068,8,2,10,M,28.74416291250706
58742,2067,2,0,2,M,29.281568546037114
101160,2068,7,1,8,P,29.034080498260558
128733,2068,7,2,9,M,29.08724942018907
174247,2068,4,2,6,J,28.59925124512583
104491,2067,6,3,9,N,29.292344406999906
111819,2068,3,0,3,E,28.552003853588825
88217,2068,4,0,4,J,28.99437066896866
110962,2068,4,0,4,E,28.90390553279606
84529,2067,6,2,8,J,29.392715278399123
144912,2068,6,1,7,P,28.944237460891507
132486,2067,6,2,8,J,29.073974770623344
138242,2068,3,2,5,J,28.89847158654672
40970,2067,2,1,3,D,29.23424445870772
85192,2068,4,2,6,M,28.934668121764837
147074,2068,3,1,4,M,28.983395943857804
174689,2067,3,0,3,N,29.45390628597715
134439,2067,6,2,8,I,29.348431192589075
141625,2068,4,0,4,M,28.912289859061456
161579,2068,5,2,7,M,28.80850359016365
135670,2067,6,0,6,M,29.101083050192464
68225,2067,2,5,7,E,29.339820034733112
39659,2068,5,0,5,S,28.841460739412387
49375,2067,3,0,3,D,29.0952642949902
169739,2067,2,2,4,D,29.32401497561512
172064,2067,6,2,8,Q,29.260841876562296
63453,2067,3,1,4,P,29.229271588391764
139003,2068,8,0,8,E,28.913616951232257
116245,2068,7,1,8,E,28.924374486848347
146990,2067,6,1,7,P,29.38962864215573
99613,2067,4,2,6,Q,29.18162811913253
117213,2067,4,2,6,E,29.133968291058093
68548,2067,4,2,6,E,29.064539817961982
124433,2067,3,1,4,N,29.17070973934333
84810,2068,6,3,9,R,28.97967146614086
74680,2067,3,2,5,J,29.137696908599303
122632,2068,4,2,6,J,29.042687146541464
158873,2067,7,2,9,N,28.94391729712957
66920,2068,6,1,7,A,29.11625798282783
146969,2067,7,0,7,M,28.98203884702229
131634,2067,3,3,6,P,28.93163882361205
85990,2068,1,3,4,C,28.802131502712577
50883,2068,9,0,9,D,28.84444167594472
59741,2067,3,1,4,E,28.978799861595
132927,2068,6,1,7,E,28.90558061352936
148574,2068,5,1,6,N,28.722676051732904
28570,2067,6,0,6,K,29.107858590933493
133538,2067,7,2,9,F,29.330757743909924
166438,2067,2,0,2,P,29.05846016146664
179835,2067,6,0,6,D,29.001650276255305
28588,2067,5,3,8,C,29.21066941435051
36085,2067,5,2,7,D,29.34092215697561
26151,2068,1,3,4,D,28.88028384114042
44892,2068,5,3,8,M,28.97396026296333
159796,2067,4,2,6,J,28.98265876495373
170602,2067,3,0,3,S,29.29441135019879
180790,2067,3,1,4,N,28.88067966560437
92399,2067,1,2,3,E,29.33559450206973
41904,2068,5,0,5,J,28.84681233296553
98013,2068,3,1,4,N,28.93196978685432
93650,2067,7,2,9,J,29.32059896187968
160432,2067,8,1,9,E,29.079762393071583
156630,2068,5,1,6,D,28.81744272708305
94935,2067,4,1,5,E,29.355624217781813
76775,2068,2,2,4,E,28.954647642787748
36183,2067,3,2,5,R,29.151503066347896
156538,2067,3,3,6,S,29.169610278347417
49973,2068,5,2,7,Q,28.781731909042215
29473,2068,11,1,12,E,28.869252903717864
111533,2068,5,1,6,E,28.7767103157696
135236,2067,5,1,6,Q,29.371334731371824
140027,2067,6,2,8,N,29.148155921681848
119029,2067,7,0,7,M,29.218607666821164
141644,2068,3,2,5,P,28.929015688636746
137431,2067,5,1,6,K,29.2311089935718
104135,2067,5,0,5,M,29.278831275418405
40586,2068,5,0,5,E,28.830088961255644
167709,2067,3,0,3,M,29.205176058018665
150030,2068,4,3,7,M,28.66149215225096
82457,2068,5,0,5,D,28.594725959900128
72280,2068,6,1,7,E,28.945471925072773
87614,2068,6,1,7,J,28.619818870161147
106364,2067,4,1,5,F,29.001928618827066
131339,2067,5,3,8,J,28.97470799499402
144783,2068,6,0,6,E,28.824922926794372
50008,2067,3,3,6,P,29.207965359671064
91959,2068,5,0,5,D,29.181423691055738
40203,2068,4,1,5,M,28.950230638580475
176027,2068,3,0,3,K,28.83882518778475
161776,2068,6,1,7,D,29.13710127270197
141265,2067,4,5,9,E,29.10610781463658
85894,2067,7,0,7,K,28.863852553607856
156733,2068,3,1,4,E,28.7833838310965
68637,2068,10,0,10,E,28.864913871357064
49595,2068,3,1,4,J,28.851140308987336
110403,2067,6,1,7,D,28.990476545660577
107303,2068,4,0,4,E,28.99979814464489
139258,2068,3,0,3,S,28.61310286399159
156646,2068,4,3,7,D,29.194439730765712
103163,2067,4,1,5,K,29.482793169411742
22453,2068,10,0,10,M,29.095876036834312
55717,2067,5,2,7,E,29.059385365718345
167649,2068,7,1,8,N,29.13472150729953
71218,2068,3,2,5,L,28.67416353153977
15974,2067,3,2,5,J,29.28869637127908
130072,2068,3,1,4,P,28.95887088830296
88355,2067,2,2,4,E,29.20091496900128
113237,2068,5,1,6,E,28.54950552553608
144121,2068,4,1,5,Q,28.952541604738407
87299,2068,1,1,2,J,29.033287814935434
16938,2068,3,2,5,E,28.67923539261505
160111,2067,3,2,5,J,29.582512129416184
75316,2067,4,1,5,K,29.34006556989906
37642,2067,2,3,5,C,29.491662527770146
16394,2068,5,2,7,P,28.931964127607063
150263,2068,6,2,8,N,29.10466237529402
61794,2067,3,2,5,N,28.90571369334124
121361,2068,8,2,10,F,28.68657837051148
47267,2068,9,3,12,J,28.87208815190591
26901,2067,8,1,9,E,29.24843196774133
157210,2068,5,2,7,J,29.2299287479167
73302,2067,2,2,4,J,29.091017797266183
180341,2068,2,2,4,E,29.10704212561052
75179,2068,7,1,8,E,28.798884714737888
161083,2067,2,0,2,L,29.017615619780347
142159,2067,5,1,6,M,29.31810436990488
100613,2068,7,0,7,P,28.856640483501863
178348,2068,5,2,7,M,28.89355692358279
88654,2067,4,2,6,D,29.16986774524824
23638,2067,4,1,5,N,29.20210503411099
166715,2067,2,1,3,N,29.236315282585338
122479,2067,6,3,9,Q,29.301006774436903
112991,2068,3,1,4,E,28.682602812339365
54922,2068,2,1,3,M,28.79322479901494
42793,2068,4,2,6,J,28.56374902659553
158527,2067,3,1,4,Q,29.52291892592516
91725,2068,2,2,4,N,28.731756460448963
92269,2068,1,2,3,E,28.78166648974249
95066,2067,4,1,5,M,29.32354469732929
124239,2067,6,1,7,M,29.280836135531622
147867,2067,7,2,9,M,29.291305995491747
182453,2068,4,3,7,M,28.90203185320167
67844,2067,2,1,3,N,29.07000839052595
53410,2068,7,1,8,C,28.79794244697692
132420,2068,8,2,10,K,29.04723397640183
21332,2067,6,2,8,P,29.15812830637571
173934,2067,2,3,5,S,28.85883092354413
159709,2068,2,1,3,M,28.78878895619872
88618,2067,4,0,4,N,29.120907002395896
74059,2068,3,2,5,A,28.566782339943508
149256,2068,4,3,7,M,29.27559737744665
19493,2068,6,0,6,P,28.56122970742282
88154,2067,3,2,5,J,29.14705666064376
89185,2068,3,3,6,Q,28.85014029524149
30989,2068,7,2,9,Q,29.05058944675106
133015,2067,3,1,4,E,28.96790476507754
156915,2068,5,2,7,N,29.197772285913352
40385,2067,2,2,4,E,29.171285461067622
98045,2068,2,2,4,N,28.678211827801302
38275,2068,3,0,3,K,28.852838303577126
164919,2067,3,1,4,H,29.137723817790704
49373,2067,9,2,11,L,28.84709251979162
182412,2068,4,2,6,N,28.87216367455658
135407,2067,7,0,7,N,29.23989265239987
16706,2067,6,2,8,S,29.197549341482272
139274,2067,4,0,4,P,29.08673266838087
62478,2068,5,2,7,M,28.80115776591966
102337,2068,4,3,7,E,29.048533918441965
89694,2068,7,2,9,Q,28.81585767698206
146003,2067,8,0,8,Q,29.252269844273425
47027,2068,5,2,7,P,28.40506259171009
160126,2067,2,2,4,N,29.446368173255788
132241,2068,10,0,10,P,29.014229372711533
73632,2067,1,1,2,A,29.460009473911043
79620,2068,5,1,6,H,28.6245673551281
106242,2068,7,1,8,F,28.811907398686184
41835,2068,7,1,8,J,29.083069457973075
167565,2067,3,1,4,K,29.151551469644357
62488,2068,1,2,3,E,29.03165216563977
89679,2068,7,2,9,N,28.822689114111405
130506,2067,2,1,3,E,29.24563343894299
74150,2067,5,0,5,M,29.481162694718005
44875,2067,4,3,7,N,29.12535676730992
123266,2068,6,9,15,I,29.052433078355648
139258,2067,2,2,4,S,29.015700278040164
23892,2068,2,5,7,A,28.798311243503665
162673,2067,7,2,9,E,29.26157651775885
96105,2068,2,0,2,Q,28.60713408753108
128118,2067,2,2,4,N,29.199997747308178
129216,2067,2,4,6,D,29.00898995194424
114092,2068,2,2,4,J,28.864091059143487
109094,2067,4,1,5,N,29.100442109798788
113699,2068,5,2,7,N,28.870601877985575
183473,2068,3,0,3,K,28.71534280630464
70050,2067,2,1,3,E,29.368327289924512
59167,2068,3,0,3,E,28.547375183239115
180518,2068,6,2,8,H,28.80050971415474
114815,2067,5,2,7,P,29.090466889198545
130012,2068,5,3,8,P,29.153260613684893
19743,2068,1,3,4,P,28.51466184911031
111120,2068,7,0,7,K,28.830853637456507
129532,2067,4,2,6,E,29.48324810688313
148779,2067,6,1,7,J,28.941866307649036
139214,2068,4,4,8,N,28.948483652340087
115892,2068,2,2,4,N,28.661405410849813
61631,2067,17,3,20,Q,28.946243289594136
64312,2067,6,1,7,D,29.05817103340623
16666,2067,7,2,9,N,29.374515538776823
140814,2068,5,1,6,N,28.711652011455968
138542,2067,4,1,5,M,29.210115429258515
41001,2067,3,2,5,M,29.0314270263423
134665,2068,6,2,8,E,29.0577781523594
135364,2068,5,1,6,M,29.015623482660907
71842,2068,3,1,4,D,28.786767251181363
169423,2068,2,0,2,J,28.76149120433749
135376,2068,5,0,5,M,28.770705692506592
68973,2067,6,2,8,J,29.48373505236514
112047,2067,5,1,6,F,28.96967456622829
64022,2067,3,0,3,E,29.37208967327354
123759,2068,4,0,4,E,28.533428443615687
123672,2068,4,1,5,P,28.91380923394473
54235,2067,4,2,6,D,29.13512780536394
76783,2067,5,0,5,N,29.12879094616225
147884,2068,5,3,8,M,28.91160616191192
24694,2067,5,1,6,N,29.295578025505133
117163,2067,3,2,5,Q,29.020101801915786
106966,2067,6,1,7,S,29.23668046720664
50405,2067,4,1,5,S,29.153644476523613
48963,2068,2,1,3,P,28.721077131559063
70110,2067,4,2,6,K,29.14764299302144
41646,2067,6,2,8,I,29.20844883332743
82235,2068,4,0,4,D,28.96156883837549
22103,2067,5,4,9,M,29.30710675909832
90026,2067,11,1,12,Q,29.16707603817729
178861,2067,8,1,9,H,28.9126954292255
92958,2068,3,4,7,P,28.647495808629746
145165,2067,7,0,7,M,29.33121767735457
146392,2067,7,3,10,P,28.97139173009929
130955,2067,6,0,6,E,29.1681216451768
48768,2067,4,2,6,E,29.178978471605472
58960,2068,5,1,6,N,28.689859584255487
124960,2067,5,1,6,E,29.2058010096294
98701,2067,5,2,7,A,28.993948043414917
134848,2067,6,2,8,M,29.28901433943284
133151,2068,8,1,9,E,28.672388851576606
103030,2068,3,3,6,C,28.751068678697347
93696,2068,3,2,5,M,28.750789283401662
76269,2067,3,2,5,A,29.067260801293287
158850,2067,5,3,8,Q,29.01070397262071
166621,2067,7,1,8,P,29.18843596984772
172502,2067,6,1,7,Q,29.01255764927372
92709,2067,4,0,4,A,29.199502007249343
156656,2067,6,3,9,I,29.297389870278167
27976,2068,5,2,7,M,28.92471558930609
78003,2068,4,1,5,J,28.658463970367343
160471,2067,6,0,6,M,29.42861526191817
27052,2068,3,1,4,E,28.877899279264334
118533,2068,2,0,2,D,28.75250956200705
118486,2067,12,3,15,K,29.362014272404007
20011,2067,6,0,6,N,29.158773266679475
132160,2068,2,1,3,M,29.028155428720613
96513,2068,2,2,4,S,28.82294803774393
84178,2068,4,1,5,E,28.90482092477757
122571,2068,2,0,2,Q,29.079058053788188
162439,2067,9,3,12,E,29.08471787317012
122018,2067,8,2,10,D,29.413913811293074
132507,2068,3,2,5,E,28.785067639196964
16123,2067,5,1,6,A,29.215373578506277
44460,2067,13,2,15,A,29.136906981889013
26531,2067,10,2,12,M,29.44636329752388
149509,2068,5,2,7,Q,28.80971157899476
173677,2068,2,2,4,P,29.00240627728877
141015,2068,3,1,4,I,29.02104635505567
93861,2068,10,1,11,E,28.382747005431916
16439,2068,6,0,6,D,28.51208666607116
155945,2067,4,2,6,E,29.6413737811047
110968,2068,4,2,6,P,28.963191937768748
117966,2068,4,4,8,P,28.845878574125088
86939,2067,4,0,4,J,29.133460597062594
74748,2068,3,2,5,N,28.476942672777447
68245,2067,4,0,4,N,29.47129258318194
139993,2068,4,4,8,M,28.699421132220237
130876,2068,4,1,5,P,28.864957041348188
51812,2067,6,1,7,J,29.14012011544338
165632,2068,5,1,6,M,28.837220219448103
123046,2068,3,1,4,K,28.57214257691522
97175,2067,17,2,19,N,28.98749721356355
146828,2067,3,0,3,E,29.434679278422507
66561,2067,3,2,5,M,28.80253000194513
148501,2068,6,2,8,M,28.57437230727565
100875,2068,3,1,4,N,28.778650045276997
22516,2068,4,0,4,M,29.08736776378121
134908,2067,3,2,5,P,29.19087538607795
117133,2067,5,0,5,J,28.902828357106472
138230,2068,3,0,3,J,28.909193315078472
92083,2067,5,2,7,N,29.207379138296798
46832,2067,3,2,5,N,29.07923983902674
53773,2068,7,2,9,D,28.872912330484034
159796,2068,2,1,3,J,28.929385118558542
76623,2067,2,2,4,S,29.52386579646004
101410,2068,4,0,4,P,28.644675784226155
123738,2067,4,0,4,Q,29.02204304033544
164856,2067,3,3,6,I,29.11491697246832
102858,2068,3,1,4,N,29.05442094803969
97833,2067,2,1,3,Q,29.262995058495
95457,2068,3,2,5,N,29.33074779237575
17602,2067,3,1,4,D,28.87487496343297
56777,2068,6,0,6,N,28.86167790141863
93497,2067,2,0,2,N,29.256755507146543
44447,2067,5,2,7,Q,29.011648132512835
56472,2067,2,1,3,Q,28.99420512162656
91720,2068,1,2,3,J,28.990909811418337
181958,2067,3,0,3,K,29.267293635707578
122360,2068,3,4,7,J,28.807046717668527
116821,2067,4,0,4,P,29.14956185043833
127165,2067,5,0,5,J,29.287793534573236
25619,2068,6,1,7,N,28.875462925723703
76994,2067,7,1,8,M,29.28765154944653
69575,2068,2,1,3,D,28.9419067798207
177400,2067,3,2,5,S,29.32996908678917
176305,2068,6,2,8,J,28.93008265147267
149423,2068,4,4,8,N,28.758053028678827
157010,2067,9,2,11,A,29.438216221469474
109787,2067,3,1,4,A,29.33762771993134
32833,2068,3,2,5,N,28.830798757742507
61601,2067,5,1,6,N,29.21660666279499
30554,2067,4,7,11,L,29.380873902610663
25982,2067,6,2,8,A,29.289199550285712
64466,2068,8,2,10,D,28.675006122097496
183246,2068,7,0,7,M,28.85274921563117
141502,2067,8,0,8,H,29.35464624255943
161501,2067,1,2,3,P,29.00091459158032
129503,2068,4,2,6,M,28.807008573173803
164650,2067,6,1,7,M,29.55316081555973
176997,2068,3,1,4,N,28.93449244085703
86922,2068,9,1,10,E,29.274691863481397
161056,2067,7,1,8,E,29.2558439538428
91755,2067,2,1,3,N,29.0767087608336
177119,2068,6,2,8,Q,29.02551716081848
55962,2067,5,2,7,N,29.216766813086178
169791,2067,3,0,3,N,29.75204914762978
134946,2067,2,2,4,M,29.128043746032457
105936,2067,1,2,3,N,28.99743282159156
31752,2068,6,2,8,N,28.71694610738497
101618,2068,5,1,6,P,28.92841695074015
116581,2067,5,1,6,N,29.21704315201256
133152,2067,9,0,9,E,29.34624113360457
130906,2067,6,1,7,Q,29.18711956306397
159785,2068,4,1,5,N,28.84492970385055
45065,2068,4,5,9,S,28.664454444470447
129502,2067,6,2,8,P,29.197576208943527
30578,2068,3,2,5,K,28.75927868042107
166030,2068,6,3,9,N,29.168375772637564
63281,2067,11,2,13,A,29.821877366746467
111775,2068,3,1,4,J,28.698218084721116
107269,2068,4,1,5,I,28.77454586310281
141308,2067,4,3,7,E,29.0100552860848
173789,2068,4,0,4,D,28.801893958705307
30403,2068,7,1,8,E,28.589997275002503
25266,2068,2,3,5,C,28.769642568518133
182629,2067,4,1,5,Q,29.293667575577647
149769,2068,5,3,8,P,28.719702403993796
150845,2068,6,1,7,M,29.11129511656722
179553,2068,6,2,8,H,28.810810725472336
36489,2067,4,3,7,I,29.11496254865559
143123,2068,4,0,4,M,28.83709138877092
176459,2068,3,1,4,N,29.08073881406189
82450,2068,4,0,4,E,28.754381221776647
33115,2068,5,1,6,I,28.90181680539327
32626,2067,6,2,8,J,29.27876783256589
23621,2067,5,1,6,E,28.913094767891025
156563,2068,6,1,7,E,28.76528502262561
64595,2068,6,2,8,E,28.666399946462672
40997,2067,5,1,6,P,28.786404453812704
174599,2067,9,0,9,J,28.9839901503596
182185,2067,6,3,9,A,29.111327843715703
75719,2067,3,2,5,F,29.43643609639087
102058,2068,5,2,7,E,28.919441651753623
42053,2067,3,2,5,D,29.17248698930198
130190,2067,4,4,8,S,29.27159760036813
165997,2067,4,2,6,N,29.373159115050942
168283,2068,6,3,9,S,28.848335118526208
147350,2067,4,0,4,M,29.18901189290322
30237,2068,2,3,5,J,28.98935633297118
91716,2067,2,2,4,N,29.19712996569741
162992,2068,8,3,11,P,28.690396988663046
114129,2067,2,1,3,E,29.00917648117508
179240,2067,4,2,6,M,29.05446277662336
67009,2068,5,2,7,Q,28.69177795572323
120287,2068,6,3,9,S,28.767924661386846
130231,2067,4,1,5,M,29.404589905621616
78212,2067,1,2,3,M,29.48089429921096
145234,2068,4,0,4,N,28.915070754217016
89508,2068,4,2,6,P,28.97989940708776
124084,2068,3,3,6,E,29.197249777804394
144010,2068,5,3,8,M,28.92823927584717
100986,2067,5,1,6,F,28.83861672222889
107265,2067,4,2,6,E,29.421631473097165
96509,2067,6,3,9,J,29.07450861563052
123044,2067,4,1,5,E,29.018115721627357
141488,2068,3,1,4,E,28.83612292356055
16259,2068,2,0,2,S,29.00132345387902
179787,2067,3,1,4,N,29.466551119552825
138411,2067,6,1,7,S,29.29097073837804
121790,2068,12,3,15,P,28.865206049271595
39711,2068,3,2,5,N,28.752122182341285
142686,2068,3,3,6,M,28.847764752073616
178288,2068,4,2,6,Q,29.27757585285528
67282,2068,10,3,13,E,28.69691858657709
61960,2067,4,1,5,J,28.707498968263728
22611,2068,5,0,5,M,28.74628060761336
145936,2068,5,2,7,J,28.892533921392104
167647,2067,5,2,7,F,28.98354682764382
22296,2067,7,2,9,N,29.140049531963665
159525,2067,1,3,4,J,29.122180566102596
47311,2068,6,3,9,A,28.904978079541294
126015,2067,2,1,3,K,28.81956798600625
147990,2068,3,2,5,Q,28.874694745816463
110962,2067,3,0,3,E,29.07516909008936
106878,2068,2,2,4,D,28.698683665193556
100380,2068,5,3,8,M,28.81298416191072
147017,2068,4,2,6,J,29.166960037424143
166221,2067,4,1,5,M,29.11679832887537
118403,2067,4,1,5,K,29.03652684030802
50374,2068,2,3,5,P,28.98320412595005
117329,2067,10,2,12,D,28.93928315906132
60881,2067,6,0,6,N,29.299438955626385
82663,2067,4,0,4,D,29.34229053498403
63721,2067,3,1,4,E,29.387327739195182
113206,2067,2,1,3,M,28.92668614861014
38062,2068,6,0,6,Q,29.036617768728657
64088,2068,8,4,12,F,28.96479802468194
81895,2068,5,1,6,E,29.06809416118094
37640,2067,4,1,5,I,29.21984945911252
172123,2067,4,1,5,N,29.200530754399946
147031,2067,2,4,6,C,29.104486152393164
18973,2067,1,2,3,J,29.146929157171343
72272,2068,6,0,6,P,28.855220004752816
20739,2068,4,0,4,D,28.84585535216599
92966,2067,6,1,7,N,29.16843009959258
144127,2067,2,0,2,P,29.31281973050073
63608,2067,5,3,8,J,29.233085700560704
49018,2067,4,2,6,E,29.235904334646648
27682,2067,9,2,11,D,29.232425074645302
156250,2067,12,5,17,A,29.3743728350375
24516,2068,5,3,8,A,28.60143203588097
180786,2067,7,0,7,M,29.204089347510774
175236,2068,5,0,5,M,28.97750946397885
116167,2067,5,2,7,K,29.12950623269261
78656,2067,7,1,8,K,29.24240857698292
69174,2067,4,1,5,J,29.423760008400954
139519,2067,5,0,5,P,28.980454866055148
83098,2068,6,1,7,N,28.747187473952263
136083,2067,5,0,5,P,29.349295825614504
139837,2067,2,1,3,P,28.87325522684148
26976,2067,5,1,6,P,29.08263413125911
26476,2067,6,2,8,D,29.081521755666905
75954,2068,5,1,6,D,28.598483687748875
125487,2067,8,0,8,J,29.220243817407923
144463,2067,1,1,2,E,28.802424572368544
38508,2067,3,3,6,J,29.136649653263675
20156,2068,5,0,5,J,29.201438988162973
138090,2068,5,1,6,E,28.774557572317462
65061,2068,5,2,7,D,28.79481055833112
147188,2068,2,3,5,J,28.952129866181757
42522,2068,4,1,5,P,28.80084764775017
121084,2067,4,0,4,E,29.19403095496115
169885,2067,36,2,38,N,29.03700507552714
19211,2068,6,1,7,J,29.05345515906109
146825,2068,9,2,11,M,28.694177426839723
150425,2068,3,3,6,N,28.747806415910787
122773,2067,7,2,9,D,29.181235977533
115702,2067,6,1,7,J,29.229179684640048
146606,2068,3,1,4,M,28.848353281934838
75393,2067,4,2,6,J,29.126653424399773
160530,2068,4,1,5,P,28.79926358980619
156260,2067,12,2,14,D,29.314650853768185
110520,2067,4,2,6,K,29.20150215576839
28929,2067,5,1,6,N,29.15990426700536
75460,2067,3,1,4,N,29.01130789856746
114350,2068,4,0,4,E,28.76434737112899
129105,2068,1,1,2,M,28.654522085630724
130536,2068,4,0,4,E,29.217155352072936
146831,2068,4,0,4,M,29.02615004271129
59305,2067,3,1,4,D,29.53617730357604
147719,2068,7,2,9,M,28.538156557331877
21246,2068,3,0,3,N,28.846141372824665
91777,2068,3,2,5,N,28.74929661450569
148105,2068,6,0,6,M,28.96501285333689
159341,2068,4,0,4,C,28.67500767278027
88494,2068,6,1,7,E,28.747957773856616
123186,2067,8,1,9,E,28.907736537008244
114751,2067,5,2,7,E,29.185964216235256
158933,2068,3,3,6,P,28.926664913906915
92984,2068,4,2,6,N,28.689551957476866
119911,2068,6,2,8,N,28.82053437775827
182614,2067,5,3,8,M,29.317119371521823
78269,2068,6,1,7,E,29.01915727732971
39762,2067,4,1,5,D,29.2729380445138
66292,2068,7,1,8,P,28.644116862933
50818,2067,5,2,7,J,29.258500355079764
118722,2068,1,1,2,D,28.905876278486215
61245,2068,5,3,8,J,28.754282529039266
36596,2067,5,0,5,M,29.339092295391666
128030,2068,6,1,7,M,28.936080851166007
101470,2067,3,2,5,K,29.26168093386284
49826,2067,5,3,8,S,29.02817596380438
54691,2067,5,3,8,J,29.2696112603825
49943,2068,3,2,5,N,28.730924602919288
41573,2067,4,2,6,J,29.06490631439387
18312,2067,12,1,13,F,29.04478166284301
156532,2067,5,1,6,J,29.41393099581325
159438,2068,7,0,7,D,29.05370536921118
148746,2068,6,2,8,M,29.08011767338597
41266,2067,6,1,7,Q,28.889910840616157
109226,2067,5,0,5,F,29.051618737218117
141978,2068,5,2,7,M,28.675114796237047
64465,2067,9,1,10,C,29.38497742887271
36520,2067,1,3,4,C,29.3918371547687
61888,2068,2,1,3,D,28.988353823429065
162451,2067,5,3,8,E,29.053037670797533
39321,2068,0,2,2,E,28.79587831277588
76031,2068,2,1,3,J,28.758373660772115
130968,2067,5,2,7,N,29.113854529070476
65702,2068,4,1,5,Q,28.789096622830744
123114,2067,3,0,3,D,29.083370052804884
83427,2068,5,3,8,Q,28.775267959863715
99781,2067,5,0,5,A,29.071651993685062
60047,2068,5,2,7,D,28.84571711169725
102120,2067,3,3,6,F,28.959719443812904
46746,2068,6,0,6,E,28.5876543520998
57007,2068,3,1,4,M,28.77505305247917
169265,2067,3,0,3,P,29.023146493190875
87699,2067,1,2,3,E,29.15866124240044
25365,2068,3,2,5,P,29.00310046598084
147225,2068,6,0,6,K,28.66364846134931
136752,2067,2,2,4,P,29.384223245587417
109916,2067,6,0,6,Q,29.17352337974233
82249,2068,7,2,9,N,28.674556721240855
148267,2068,5,0,5,M,29.05774391365408
60175,2067,2,1,3,D,29.21587340019701
41252,2068,5,1,6,M,28.925229583686328
94823,2068,6,1,7,N,28.58381269612533
51664,2067,5,2,7,E,29.138211531341117
147084,2068,6,2,8,Q,28.94195838240888
67261,2067,1,3,4,E,29.200217066141352
135051,2067,5,2,7,P,28.922731198871908
163552,2067,3,0,3,J,29.253670553415045
100380,2067,4,3,7,M,29.41829051890224
63794,2068,5,1,6,E,28.94665743788461
59446,2068,1,2,3,N,28.632763032907683
145316,2068,3,2,5,K,28.710602801607312
158818,2067,5,1,6,N,29.15272043821033
37249,2068,5,0,5,M,28.627334729625638
68245,2068,3,2,5,N,28.85487896965852
127688,2067,9,1,10,J,29.195723717531347
151412,2068,4,4,8,P,28.7193641973364
19163,2068,2,3,5,P,29.18647284325712
57271,2068,2,2,4,M,28.88867599561213
132934,2068,3,2,5,N,28.734858202730408
92661,2067,5,2,7,J,29.36406490938613
16413,2068,2,0,2,D,28.82976976829528
101194,2068,8,0,8,E,28.915382189292952
51664,2068,3,2,5,E,28.746344883469103
130805,2068,2,2,4,J,29.34624145074504
26527,2067,6,2,8,E,29.243034348254994
71767,2067,6,2,8,J,29.40435895552556
147041,2068,4,0,4,M,28.619056833518822
147720,2067,3,1,4,M,29.034563189087827
24021,2068,2,2,4,D,29.00721966848064
103302,2067,6,3,9,F,29.19723052075753
117240,2068,5,2,7,F,28.9171534064075
149872,2068,8,0,8,P,28.685419471592287
121984,2067,6,0,6,E,28.927172981032747
47530,2067,3,0,3,N,29.194014337910403
66270,2068,10,2,12,Q,28.529867182492303
144663,2067,4,2,6,M,29.29280842952905
81373,2067,4,1,5,N,28.95297633400393
145782,2067,5,2,7,Q,29.009734513523664
31531,2067,4,0,4,P,29.449124272914425
130475,2068,4,1,5,M,28.8978805164034
93551,2068,2,0,2,S,28.6231717189662
121982,2067,3,1,4,K,29.202964503313137
103455,2068,6,0,6,N,28.68747456901932
92473,2068,6,2,8,M,29.099625330064647
70636,2067,2,4,6,L,28.91704423921377
56203,2067,7,2,9,Q,28.988029120937583
111725,2068,5,2,7,E,28.729835446519857
104066,2068,2,0,2,M,28.631944233012256
163282,2068,5,0,5,A,29.190014824796386
40731,2068,2,2,4,S,29.15206120021765
171548,2067,3,1,4,D,29.04237187896403
143674,2067,3,0,3,J,28.95890450692001
176801,2067,6,2,8,P,29.78012713229694
51619,2068,4,3,7,I,29.076470355962808
174983,2067,3,2,5,J,28.897808685608524
157701,2067,3,1,4,N,28.91102412922761
59020,2067,5,3,8,Q,29.192017630589387
118571,2068,5,1,6,S,29.09449064293208
66239,2067,5,0,5,H,29.063837202684887
119640,2068,6,1,7,J,28.843403952059543
44637,2067,4,3,7,D,29.350317222944906
18218,2067,3,1,4,P,29.27272031525557
47628,2067,5,2,7,E,29.23694150122135
130505,2068,4,0,4,E,28.67607879280993
162764,2068,5,4,9,C,28.96489089107184
83538,2067,6,2,8,E,29.090190867038395
24722,2068,10,0,10,D,28.869583236770417
121465,2067,3,2,5,A,29.2382618473188
119566,2067,3,2,5,S,29.049388037203578
128441,2067,4,0,4,M,29.243366686716104
25596,2067,5,3,8,J,29.04138242963288
117465,2067,4,3,7,J,29.20342873085521
127429,2068,4,1,5,Q,28.808884717225247
145681,2068,6,1,7,M,29.024017089748583
173211,2068,6,2,8,M,28.589799424494995
83713,2067,6,2,8,M,29.254533378183872
132124,2067,3,1,4,E,29.258113736812195
99809,2067,3,3,6,M,29.22258693738614
111646,2068,8,1,9,J,28.990713021194438
146289,2068,4,2,6,M,28.868197626444765
31232,2067,5,3,8,J,29.192224562263647
172197,2068,2,2,4,Q,28.955559995071788
144216,2067,5,1,6,Q,29.13400159837517
70167,2067,5,2,7,E,29.50910065947552
59656,2068,17,2,19,D,29.261859970068837
116852,2068,4,0,4,P,28.59521832757405
36370,2067,3,2,5,P,29.027305250173715
170397,2068,5,2,7,C,28.944042858342502
97643,2068,4,0,4,Q,29.064782687754526
163454,2067,6,0,6,P,29.053958554970244
63859,2067,2,1,3,E,29.06990869643764
17565,2067,5,2,7,D,29.035775865581098
125067,2067,4,2,6,E,29.501590436629478
173674,2068,5,0,5,N,28.884277075821476
93131,2067,5,2,7,J,29.381717683446936
88176,2067,4,1,5,E,29.43285261669408
32170,2068,3,3,6,E,28.86499040813809
88846,2067,4,1,5,Q,28.88531402566983
66389,2067,6,1,7,N,29.4440167121686
108535,2068,2,0,2,E,28.927468232298164
78702,2068,3,0,3,M,28.55909936923154
104070,2068,4,2,6,E,28.855123803058397
69840,2068,12,2,14,Q,28.84248932909814
171444,2068,4,0,4,E,28.78155706855777
59131,2068,20,4,24,D,28.90525870704669
145212,2067,4,2,6,J,29.256398457725584
82969,2067,1,2,3,D,29.283064331301677
90449,2068,5,0,5,N,28.568428462671857
19768,2068,1,3,4,I,28.89840271630295
37504,2067,3,2,5,E,29.44252538153782
134675,2068,3,0,3,P,28.741344112833595
128892,2068,5,2,7,N,28.74267275687474
148363,2068,2,3,5,J,28.66354004462426
120531,2068,2,2,4,J,28.740041156826603
136849,2067,4,0,4,E,29.006188472475674
67936,2067,7,2,9,P,28.80971284921254
61576,2068,13,3,16,Q,29.142407472797284
143020,2068,6,2,8,E,28.842243067501247
103206,2067,3,0,3,E,29.275812321815792
139551,2068,4,2,6,M,28.66927300353051
121707,2068,6,3,9,S,28.975721660722563
63371,2067,4,2,6,E,29.36208166633749
56436,2067,5,1,6,D,29.353583112983543
59295,2068,5,0,5,E,29.010861800458628
37716,2068,5,2,7,E,29.045429313542588
109130,2067,4,3,7,N,29.33066601749666
36273,2067,6,1,7,Q,29.234740410711865
54912,2067,5,3,8,S,29.23094168216089
38944,2068,3,2,5,E,28.906994744099208
37599,2067,6,2,8,P,29.01404020617177
104876,2068,5,0,5,D,28.81146066285701
175304,2067,16,1,17,G,29.32627927524564
16958,2067,5,0,5,E,29.270235784579917
48045,2068,3,0,3,E,28.79721475109448
73710,2067,7,1,8,J,29.105574392356424
64056,2067,5,1,6,E,29.15350620955717
174256,2067,5,1,6,J,28.973928992211945
138778,2067,5,1,6,M,29.192053557860035
169583,2067,6,0,6,E,29.27492315414021
144619,2067,3,0,3,M,29.253020557206384
73359,2067,1,3,4,M,29.210443897936734
108620,2067,4,0,4,S,28.597216663793454
167270,2068,4,1,5,M,28.677085727644187
39956,2068,4,0,4,D,29.077853143116112
62305,2068,7,2,9,J,29.06418586505424
92986,2068,4,2,6,E,29.036084552324844
107503,2067,3,2,5,E,29.30099155421174
172883,2068,7,1,8,N,28.83625451861545
46298,2067,6,1,7,A,29.144248905372223
142223,2068,6,2,8,N,28.693740677913148
165106,2067,4,1,5,N,29.220140613474435
72017,2067,2,2,4,C,29.43593124971398
138214,2068,7,1,8,E,28.783872698683805
165258,2068,7,0,7,M,28.493896904629157
146835,2068,3,3,6,M,28.930185698747337
96010,2067,13,3,16,K,29.19806082202224
92003,2068,4,2,6,A,29.204214410664285
91614,2067,3,2,5,J,28.96245843589259
47645,2067,3,2,5,Q,29.16765197050145
76648,2068,6,0,6,E,28.651350428385623
118755,2067,2,1,3,M,29.10536500889864
87748,2068,6,1,7,D,29.338406050620883
112463,2067,5,2,7,I,29.47741930381665
119937,2067,6,2,8,E,29.27323835926512
180591,2068,4,2,6,Q,28.56206358720441
177191,2067,8,2,10,P,29.42284858177853
110118,2068,6,1,7,D,28.75120812383765
87934,2067,1,2,3,P,29.32255702006205
28007,2067,4,1,5,E,29.158359505504567
104262,2067,8,1,9,G,29.193464088215038
24265,2068,7,2,9,J,28.968708540361703
179288,2068,5,1,6,Q,28.754791239245016
145595,2067,4,1,5,P,28.996222727381777
99775,2068,6,1,7,J,28.93813142221809
179604,2068,5,1,6,E,29.037192852218983
56751,2067,7,0,7,Q,29.150186628049525
19930,2067,6,0,6,D,29.04987316117996
94311,2068,3,2,5,N,28.540573089092717
160773,2068,3,0,3,P,28.92885629470592
101528,2068,4,1,5,Q,28.781821904427616
39295,2067,4,0,4,S,29.20265013734963
16123,2068,7,1,8,A,28.956886598887717
137876,2068,6,3,9,P,28.867465965126705
31394,2068,7,2,9,D,28.86759896916268
17336,2067,7,0,7,D,29.18595594347269
134824,2068,5,1,6,J,29.03819035927388
56456,2067,6,0,6,M,29.015978218446744
18981,2068,10,1,11,D,28.28673020616884
93339,2068,7,0,7,D,28.96633971692788
139958,2067,6,1,7,P,29.317898849605267
31903,2068,2,1,3,M,28.45472478818262
173631,2067,5,3,8,P,28.99766843896689
182162,2068,6,1,7,N,29.23767080420437
78509,2067,4,2,6,N,29.006817258190974
16929,2067,5,1,6,H,29.07801232707672
183172,2068,4,1,5,M,29.038214785039663
16185,2068,6,1,7,Q,28.70211165260089
172027,2068,3,1,4,P,29.00819805392721
148018,2068,1,2,3,Q,28.74540119433605
60973,2068,5,1,6,E,29.002988024771213
140198,2068,5,2,7,E,29.077138796276728
125398,2068,8,3,11,N,28.92568666872585
86671,2067,9,0,9,E,29.350075326169133
139915,2067,2,2,4,P,29.273833683298687
44308,2068,9,0,9,P,28.946552490025542
177261,2068,7,1,8,D,28.38382205854526
61531,2068,4,1,5,D,28.895654356951013
178679,2067,6,1,7,E,29.15910396592388
171339,2068,4,2,6,N,28.84987094799226
91573,2068,13,3,16,N,29.01429941790004
32337,2067,3,2,5,Q,29.37119453337773
56347,2067,6,1,7,Q,29.571373428504323
47527,2067,14,2,16,N,29.49329112421976
144343,2067,9,1,10,M,29.04016106475998
97066,2068,3,1,4,N,28.939256230049423
165262,2067,2,2,4,P,29.13202871216808
149433,2068,6,2,8,M,28.766807081393303
63154,2067,2,1,3,E,29.11062978000337
66312,2068,6,1,7,E,29.17624158526938
149759,2068,4,2,6,Q,28.988237217407097
29988,2068,3,2,5,J,28.59279849239716
92148,2068,1,4,5,J,28.657896358508328
72283,2067,5,0,5,E,29.267165750697643
92474,2067,4,3,7,E,29.177768977380143
89090,2067,3,0,3,K,29.29961049851769
88032,2067,5,2,7,C,29.069718801110305
22423,2068,6,2,8,C,29.058118072373315
67560,2068,6,0,6,Q,28.515519317543024
170933,2067,5,0,5,N,29.23890586078313
170589,2068,4,2,6,K,28.742092128427466
49984,2067,3,1,4,M,29.29411798451723
180173,2068,3,1,4,N,28.737091325178792
29423,2068,3,1,4,E,28.89298517159792
63693,2067,3,2,5,A,29.4017664711538
147723,2068,7,0,7,K,28.949758002853333
47310,2067,4,4,8,E,29.17949424193781
93621,2068,5,1,6,N,28.8996822084204
129308,2068,5,1,6,Q,28.78924947787406
78226,2067,5,3,8,N,29.400093824469764
159709,2067,4,2,6,M,29.131772874554613
84214,2067,7,2,9,I,29.161030949948884
171426,2068,6,2,8,N,29.0560510373292
140059,2067,2,3,5,P,29.33425950348081
161189,2068,6,2,8,J,28.640571617076223
50653,2067,2,0,2,N,28.83404694302466
77897,2068,3,2,5,M,28.729357662120435
72542,2067,6,2,8,J,29.095194522798558
63414,2068,7,3,10,N,29.05568400596314
122437,2068,2,2,4,N,28.87604369630325
139505,2067,5,2,7,M,29.01481438925164
90358,2068,2,2,4,Q,29.06755207187626
63548,2068,6,1,7,J,28.96831743204868
25747,2067,2,1,3,E,28.88136344605009
18627,2067,5,2,7,P,28.950973749223277
100758,2068,3,0,3,N,28.794158163353675
91699,2068,4,0,4,E,28.78330245152603
50585,2068,5,2,7,J,28.78810701322225
96670,2068,2,0,2,E,28.751487208020837
64147,2067,11,1,12,E,29.249597246070184
100374,2068,4,0,4,N,28.76862106207157
21855,2067,5,0,5,Q,28.957700280890084
37275,2068,4,1,5,E,29.136122459392965
175736,2068,4,0,4,E,28.58350601244504
72487,2068,2,2,4,P,28.908947062304573
75179,2067,4,2,6,E,29.023334931528737
31145,2068,6,1,7,E,28.7532222030704
44908,2067,3,1,4,J,29.19792608346604
78559,2068,3,4,7,N,28.725692314841496
63301,2068,10,1,11,A,28.55750355983803
44566,2067,8,3,11,E,29.327763182729147
47673,2067,7,1,8,E,29.055136622306108
27703,2068,4,2,6,E,29.231154472849138
111501,2067,5,1,6,P,29.05826917531497
16319,2068,6,0,6,D,29.33178240716079
32855,2067,5,1,6,E,29.419882692990573
139219,2067,6,2,8,M,29.349883295181804
47354,2067,6,0,6,P,29.018910162442342
140235,2068,5,3,8,P,28.67996615247727
51316,2067,6,2,8,E,29.20485642624929
173259,2067,3,1,4,Q,28.903819637949727
164901,2067,5,2,7,D,29.21083938605315
49373,2068,5,2,7,L,28.748826932486946
21669,2068,5,1,6,Q,28.83227234801355
22393,2068,3,2,5,Q,28.820729510156053
73529,2067,2,1,3,Q,29.112272776901094
141672,2067,4,1,5,K,29.10171795121469
131792,2067,3,0,3,Q,29.364841015324902
119139,2067,8,1,9,J,28.964555734469076
39659,2067,5,0,5,S,29.20622801639809
57435,2068,6,0,6,N,28.8675753388632
42121,2068,5,1,6,Q,29.25536025888561
39867,2068,2,1,3,D,28.65715760056062
33170,2067,2,1,3,E,29.476982645525457
74616,2067,1,3,4,I,29.1030509493114
173702,2067,3,0,3,E,28.916962281620396
16319,2067,6,1,7,D,29.28428937782596
81639,2067,3,4,7,E,29.056025920619447
146721,2068,6,1,7,J,28.890600254268374
175876,2067,3,1,4,E,28.79907323307873
89929,2068,5,1,6,S,28.872027209454902
106425,2068,7,2,9,N,28.863046938755737
147818,2068,6,1,7,M,29.06982663776875
127798,2068,7,4,11,F,29.02064456036681
17533,2068,4,2,6,D,28.671870929485017
25354,2067,2,2,4,D,28.733545466755256
20008,2068,5,2,7,S,28.68715329993236
117143,2067,4,0,4,P,29.146587923790324
142302,2068,2,2,4,Q,28.961325963120597
54922,2067,4,2,6,M,29.44227738543661
108897,2067,6,0,6,N,29.344619196931827
146937,2068,1,3,4,Q,28.89081288771378
23814,2068,5,0,5,D,28.48633807425181
71410,2067,5,0,5,J,29.572984049751994
109776,2068,6,2,8,N,28.765236953669348
178954,2067,5,1,6,S,29.020674241014014
121906,2067,3,2,5,P,29.397555408350744
20710,2067,7,1,8,L,29.382764308408703
181920,2067,8,0,8,N,29.470208250603548
52668,2068,7,2,9,E,28.74194641907306
47673,2068,4,1,5,E,28.97733188134876
164080,2068,6,1,7,M,28.9496116369977
57619,2068,5,1,6,M,28.816065246484925
142716,2067,3,0,3,M,29.49439562655688
120978,2068,4,2,6,K,29.017881032845448
180928,2067,4,1,5,N,29.329823446115288
113400,2067,6,0,6,P,28.96669674591604
53263,2068,4,2,6,E,28.993531130277965
86564,2067,5,3,8,E,29.06668189873973
181800,2068,6,2,8,M,29.070448952919605
115468,2068,5,2,7,J,28.93266300577648
93781,2067,8,0,8,M,28.80701735423608
33905,2067,1,3,4,J,29.31603632317082
128624,2067,7,1,8,N,29.28970416975596
94951,2067,2,2,4,S,29.250364424337928
38478,2068,8,3,11,P,29.13640588871732
34894,2067,4,0,4,Q,29.47088148248276
148170,2068,3,0,3,M,29.197205919249825
111347,2068,6,1,7,J,28.863500611793427
172064,2068,4,1,5,Q,28.7061273322614
85484,2067,2,3,5,E,29.086354107688692
144007,2068,0,4,4,M,28.813038795633737
41481,2067,7,2,9,M,29.20693542923384
74591,2068,3,0,3,N,29.17897352209929
21140,2067,3,2,5,M,28.945400018082665
96937,2067,4,2,6,Q,29.180654253923542
55902,2067,6,2,8,N,29.386557291845453
64118,2067,2,0,2,N,29.066356864498847
61753,2068,3,2,5,D,28.74108868122679
134695,2068,7,2,9,J,28.98624538659677
72305,2068,8,4,12,N,28.986082991550926
98872,2067,2,1,3,N,29.42101703808437
158537,2067,5,0,5,A,29.14432643268105
64481,2067,5,0,5,H,29.281518361453543
182848,2067,6,0,6,R,29.34572326179858
107593,2068,6,1,7,D,29.16877506236804
61531,2067,2,1,3,D,29.266623103311872
155936,2068,5,2,7,F,28.61328386946737
133093,2067,5,0,5,E,29.217042732180403
81804,2068,6,2,8,Q,28.84404568418155
66817,2067,5,2,7,Q,29.343795786292684
36450,2068,7,1,8,D,28.710554655787035
72156,2068,2,1,3,J,29.08013010746631
56036,2068,3,1,4,E,29.089733374377285
145443,2067,5,0,5,P,29.178769568773617
149743,2068,4,3,7,A,28.84307347816528
81840,2067,6,3,9,J,29.437785077280587
136258,2067,4,1,5,J,28.942350821982732
148579,2067,4,1,5,M,29.216331659663176
62399,2068,6,0,6,N,28.8258943383916
15802,2068,2,2,4,A,29.036255855300112
113640,2067,5,1,6,J,29.046001771976236
66052,2068,5,2,7,D,28.826664858121525
159852,2068,8,3,11,E,28.871455376606697
47031,2067,7,2,9,S,29.19344369799532
115138,2068,3,1,4,I,28.77225746144482
131034,2067,2,2,4,J,29.41261504425585
106371,2068,8,1,9,J,28.84735057372677
104490,2068,8,1,9,N,28.71819948775089
37967,2067,5,1,6,Q,29.00177835285673
155970,2068,6,0,6,Q,28.82615363924082
27608,2067,1,3,4,Q,29.02215046487241
24163,2067,2,1,3,N,29.333522338431845
94153,2068,3,0,3,D,28.821090212356523
136691,2068,6,1,7,N,29.021753732845788
84250,2068,6,1,7,Q,28.767816935239956
19738,2067,2,1,3,D,29.32584868717253
19840,2067,4,2,6,C,29.299712581466185
66262,2067,3,0,3,E,29.066383695946996
169986,2068,4,2,6,D,28.712874803211268
156298,2068,4,1,5,M,28.840423299915816
48041,2067,12,2,14,D,29.35719020095088
96260,2068,6,1,7,P,28.964208680298437
169906,2067,2,1,3,N,29.39693794912784
155890,2067,3,1,4,F,29.232305918936262
17459,2068,2,3,5,Q,28.918811395131197
36756,2067,9,2,11,M,29.343370317419268
55354,2068,5,3,8,E,28.96526911485686
167431,2068,3,2,5,D,28.765992013917355
172596,2068,6,2,8,E,28.845665203576026
45766,2068,5,2,7,E,28.77013057186326
69413,2068,3,0,3,E,28.699327201158624
59004,2068,5,2,7,N,29.198420073837244
114231,2067,8,2,10,Q,29.021710780009908
112639,2067,2,2,4,Q,29.15527522821368
158374,2067,4,2,6,E,29.227270295077886
145100,2068,3,0,3,M,28.858083115093205
29282,2068,6,1,7,E,28.91889048608519
73914,2068,6,1,7,N,28.787700138400837
178142,2067,6,1,7,M,28.96532889713348
20974,2067,3,1,4,N,28.94257731117176
81306,2067,4,3,7,E,29.459251612696335
101978,2067,7,1,8,E,29.56405298836021
100460,2068,7,0,7,M,28.774000873527427
120602,2067,2,3,5,J,29.132110722627186
56663,2067,4,1,5,J,28.737216248977
121875,2067,7,1,8,E,29.57580835270185
181372,2068,4,2,6,E,29.09410918969792
182579,2067,5,0,5,Q,29.14468729207131
100770,2067,3,1,4,P,29.366200149060063
41793,2067,4,1,5,M,29.20948607301549
36447,2067,1,1,2,I,29.275367740205624
160306,2067,6,2,8,E,29.254219548602997
37131,2067,4,1,5,E,29.16159255735445
65229,2068,2,2,4,N,28.775052799098056
159212,2068,2,3,5,E,28.975812558979243
92039,2068,2,1,3,E,28.88515969809116
75189,2067,3,1,4,N,29.27779334968785
134316,2068,11,0,11,K,29.411900228459174
143861,2067,4,1,5,M,29.055881942620992
93255,2068,6,0,6,F,28.717084405435884
102493,2067,5,0,5,A,29.1435477789784
163908,2067,4,2,6,M,29.222758992444508
114925,2068,6,1,7,J,28.997757748102178
175425,2067,4,2,6,N,29.252631405135286
21747,2068,3,3,6,P,28.57004789481739
96420,2067,4,0,4,N,29.113879196179766
62771,2068,5,0,5,J,28.874469337645
128331,2068,3,1,4,J,28.57359155858977
121373,2067,6,1,7,J,29.259528653813295
138873,2067,5,1,6,J,28.930598332780036
45729,2068,2,1,3,Q,28.76507160706043
76531,2068,3,1,4,E,29.046516644576
109201,2068,3,2,5,N,28.93425836839499
123710,2068,5,2,7,N,28.876949419884745
157786,2068,1,3,4,Q,29.122271845637105
54338,2068,3,0,3,J,28.950962826422696
87744,2067,6,1,7,J,29.161191400647866
97208,2068,5,0,5,A,28.87888936213867
22553,2067,7,1,8,Q,29.179829615160983
178915,2067,6,0,6,E,29.063307609644752
107897,2067,4,3,7,K,29.07163798475053
179837,2068,7,1,8,Q,28.445901783751427
98209,2067,5,2,7,N,29.08987718359722
127582,2068,7,1,8,E,28.875239268615363
101979,2067,2,0,2,K,29.38206825580405
22214,2068,6,2,8,N,28.75590564133749
92611,2067,2,2,4,M,29.176779178464955
99126,2068,3,1,4,E,28.499295286061315
59571,2067,6,1,7,E,29.25842206573373
95651,2067,6,3,9,R,29.340112990186377
164616,2068,3,2,5,E,28.727934172522318
53794,2067,2,0,2,F,28.968035350596
173818,2067,4,2,6,J,29.239286988617117
73497,2067,4,0,4,M,29.291206421733246
114240,2068,5,3,8,J,29.17443494761964
56389,2067,3,2,5,D,28.990709927174915
65442,2068,1,3,4,M,28.894744513513132
57583,2068,2,2,4,J,28.987410238060924
25702,2068,2,0,2,A,28.82402140988917
92261,2068,6,1,7,P,28.63421729264713
82445,2067,2,2,4,E,29.24721852990033
64859,2067,5,0,5,J,29.47936346521116
138142,2068,2,0,2,P,28.68563188736221
104907,2068,2,2,4,P,28.535243346082037
165078,2068,4,1,5,N,28.75743798977612
143041,2068,4,2,6,E,28.845497586233385
129355,2067,3,2,5,P,29.404807833905988
132189,2068,7,0,7,K,28.87282329277748
97737,2068,6,1,7,D,29.023981930607103
160678,2068,3,0,3,K,28.80402053901374
163529,2068,11,0,11,E,28.926890646131667
36183,2068,6,2,8,R,28.95650953472513
17078,2067,5,2,7,D,29.54535693309317
33611,2067,6,0,6,P,28.87808023995232
57243,2068,2,0,2,M,28.54903859030368
101068,2067,3,2,5,N,29.429927243059787
38739,2067,6,2,8,E,29.08789623770955
177002,2068,7,1,8,P,28.345817118987856
134765,2068,6,2,8,N,28.57607653265461
104566,2068,11,4,15,N,28.869232551281407
97112,2068,6,2,8,N,28.812555539061066
56393,2067,10,2,12,P,29.046467780170143
109725,2068,4,1,5,J,28.816886798574476
93388,2067,2,2,4,D,29.18928854324957
36910,2068,1,11,12,M,28.77168340507447
54491,2068,6,2,8,N,28.901067892531863
143956,2067,4,1,5,N,29.042070081439977
134359,2067,2,3,5,N,29.522627652414663
113072,2068,3,1,4,M,28.94648853182462
160774,2067,8,0,8,P,29.1451397818707
158627,2067,3,1,4,D,29.29765603581405
27399,2068,3,0,3,N,28.86622779640257
99029,2067,6,1,7,Q,29.24768056190569
27314,2067,3,3,6,N,29.11780384266672
183407,2068,7,1,8,E,28.83468761121047
63414,2067,8,2,10,N,29.496903688573028
64214,2068,5,1,6,D,28.79605490998932
144318,2068,3,0,3,Q,28.999444638854463
157482,2067,1,2,3,P,29.12764872087148
159916,2068,2,0,2,C,29.07597708727606
106165,2068,2,2,4,E,29.081791195316843
117240,2067,5,1,6,F,29.005022500872965
24694,2068,7,1,8,N,28.963687967427656
95740,2068,3,3,6,J,28.584061026366268
91699,2067,6,0,6,E,29.272122159995032
165054,2068,5,2,7,P,28.873555170219863
28797,2068,6,2,8,K,28.429595703615117
61777,2068,4,1,5,D,28.84752657103689
27795,2067,5,0,5,J,28.92221780780229
150380,2068,8,1,9,Q,28.913754576575077
133648,2067,4,3,7,N,29.15390843642289
26158,2067,6,2,8,D,29.256184333986127
101603,2067,4,1,5,E,29.04004784470144
99310,2067,3,1,4,N,29.41634973954004
103437,2067,6,1,7,M,29.175220957799045
23657,2067,4,0,4,N,29.25711033050631
125359,2067,2,2,4,P,29.356147112125843
59387,2067,5,0,5,Q,28.937255451645203
45969,2068,4,2,6,R,29.09525514432367
141659,2068,8,1,9,P,28.723534394178888
17283,2068,6,0,6,N,28.835386434797478
70495,2068,4,0,4,J,28.59332111408839
161380,2067,2,3,5,J,29.235206996999377
18349,2068,4,1,5,A,28.619128250276443
41162,2067,4,1,5,D,29.264032639545604
165183,2067,6,1,7,P,28.908957377951538
149359,2068,6,0,6,M,28.62501293500109
90587,2068,3,0,3,N,28.95761949127603
71768,2068,4,4,8,E,28.959949837998
179554,2067,6,1,7,P,29.108443559026806
172531,2068,6,0,6,E,28.93687282062859
127429,2067,4,1,5,Q,29.134557252897427
24236,2068,5,1,6,N,28.695393261727563
27563,2068,4,2,6,J,28.920545683393943
73302,2068,1,2,3,J,28.84306077187869
115683,2068,6,0,6,J,29.16474679752637
117020,2068,10,4,14,A,28.53132473482172
41225,2067,2,1,3,J,29.307129782030604
147024,2068,11,3,14,E,28.97744514238201
29988,2067,3,3,6,J,29.32062300953837
166184,2067,3,0,3,Q,29.085025233088345
103623,2068,8,2,10,E,28.454367260433
59638,2068,5,1,6,N,28.967641400927057
165475,2068,3,2,5,D,29.17555918773312
104069,2067,7,1,8,Q,29.250471809689717
159653,2068,6,0,6,H,28.671359040836037
165418,2068,6,0,6,P,28.742592640641057
97710,2068,2,3,5,E,28.95440097738831
166405,2067,2,1,3,N,28.97516688565478
25518,2068,2,2,4,N,29.01045794340083
119830,2068,3,0,3,K,28.682561030987603
97647,2068,7,2,9,J,29.14522221136741
163030,2068,6,2,8,K,28.60021049162468
59064,2068,3,0,3,Q,28.801213377693703
111601,2068,3,3,6,E,28.827650208486865
76973,2067,7,0,7,E,29.51069534091671
81770,2068,4,1,5,P,29.273333370315456
115775,2068,3,2,5,D,28.647155692122038
64721,2068,6,1,7,E,28.58608455960753
61777,2067,2,0,2,D,29.33822528399361
115224,2067,2,1,3,P,29.160020247104683
22735,2068,4,1,5,M,29.292203318288625
165992,2067,2,1,3,M,28.773535606530004
78322,2067,1,5,6,E,29.45319031392425
147737,2067,5,0,5,M,28.9364511973212
86801,2068,6,1,7,P,28.913128923066967
181071,2067,4,2,6,A,29.52274702757016
75261,2068,3,1,4,E,28.84039198055689
65285,2067,4,1,5,E,29.487345634330303
97885,2067,4,2,6,J,29.252508937988065
93649,2068,5,2,7,P,28.737979494862856
104443,2068,2,0,2,K,28.812763675955686
56889,2067,2,3,5,J,29.288464731795692
23502,2068,2,1,3,J,29.022556481489897
117161,2068,3,0,3,Q,29.13201814032704
102123,2068,6,2,8,Q,29.014659933521184
150515,2068,6,2,8,A,28.979035722179898
157105,2068,6,3,9,M,28.768252978301952
138082,2068,4,2,6,S,29.011567010848182
18700,2067,7,3,10,A,29.27243446491448
75244,2067,3,1,4,E,29.121937937683622
82530,2067,3,0,3,N,29.30171782585037
86572,2068,2,2,4,D,28.672393767021717
20963,2068,5,1,6,J,28.67561729973507
128082,2068,5,2,7,E,28.703976555557343
131701,2067,3,1,4,E,29.082954063906165
133013,2067,5,1,6,N,29.11534133690536
39749,2068,4,0,4,N,28.57500877519816
23721,2068,5,1,6,Q,28.69499009498013
124756,2068,6,1,7,M,28.799327235894875
47460,2067,3,1,4,M,29.40456537104088
30960,2067,5,1,6,E,29.17511767039993
94119,2067,5,2,7,D,29.115333561167105
82091,2068,6,2,8,D,28.88888080116242
47502,2067,5,0,5,E,29.009527892636758
74930,2068,3,1,4,N,29.13323464873188
139363,2068,5,1,6,N,29.027918995186443
128204,2068,6,0,6,P,29.01081420645227
89737,2068,7,0,7,Q,28.699352852926094
116528,2067,2,2,4,E,29.237855328747123
137299,2067,6,2,8,P,29.29215376519982
44333,2068,6,2,8,A,28.673402506863223
69117,2068,7,0,7,M,28.903161900640423
113450,2068,4,2,6,E,28.939900014462165
91956,2068,5,3,8,M,28.694967312027067
165279,2067,3,1,4,E,29.2798613972908
115722,2068,6,1,7,E,29.00954507806169
175485,2067,3,2,5,P,29.078172042160936
34498,2068,4,3,7,N,28.879706987158297
47813,2067,5,0,5,P,29.67107647731873
147720,2068,3,2,5,M,28.486005697174928
137715,2068,4,3,7,Q,28.987557606123517
18552,2068,5,2,7,N,28.93383091130273
77476,2067,6,1,7,E,29.165130170836218
111280,2068,3,0,3,E,29.366838722025012
133832,2067,4,1,5,J,28.935111763184175
119266,2068,3,2,5,P,28.7059780608224
136879,2068,3,3,6,P,28.773135466198013
94460,2067,6,2,8,M,29.416979902570684
92440,2067,6,2,8,N,29.193848209001924
161785,2068,6,2,8,K,28.743214247018336
158734,2067,5,2,7,P,29.341265119237043
87778,2067,2,0,2,E,29.058186696255834
157123,2068,12,4,16,E,28.794379851884035
28161,2067,4,3,7,M,28.937208762347385
162867,2067,5,0,5,M,29.239440469613623
103942,2068,2,2,4,E,28.80308077587751
51141,2067,4,2,6,N,29.11784026662972
92627,2068,13,5,18,D,28.866608855961022
70925,2068,5,2,7,N,29.01113568946028
123130,2067,6,0,6,E,29.15004733272592
98369,2067,6,1,7,E,29.316641556660343
75602,2068,3,2,5,K,28.75044177723682
164825,2068,3,1,4,J,28.91036477209912
114419,2067,8,0,8,J,29.346769040987024
166109,2067,4,3,7,S,28.99602618753513
54266,2067,5,1,6,N,29.30832644108637
103219,2067,4,0,4,J,29.254170942273745
55822,2068,6,0,6,E,29.00323526531021
123221,2067,1,1,2,E,29.05115064975015
44751,2068,4,2,6,D,29.035027057806744
49636,2067,6,2,8,N,28.954621080519075
58811,2067,3,3,6,E,29.09888519152528
33117,2067,7,1,8,E,29.08568376925269
41473,2068,7,1,8,N,28.805045796529622
108965,2068,9,7,16,K,28.60675788152461
109995,2068,3,0,3,A,28.517497649597654
175959,2068,4,2,6,Q,29.35817979879108
21476,2067,5,1,6,Q,28.884842159023197
182175,2067,7,1,8,F,29.32349874995961
31113,2067,6,0,6,E,29.230735027205007
78334,2067,12,5,17,P,29.023512734603727
142405,2068,5,0,5,E,28.77002986918804
20054,2067,3,1,4,N,28.967494207754243
67578,2067,6,3,9,Q,29.2676451393266
108994,2068,4,2,6,N,28.74516097388793
177107,2067,2,1,3,N,29.28669080404407
47404,2068,6,0,6,A,28.58492931624638
138211,2068,1,4,5,M,28.96535292679411
149945,2068,5,2,7,M,28.724948331318863
74481,2067,4,0,4,N,29.29327490263213
147807,2068,3,1,4,M,28.820433113220183
81432,2067,2,1,3,N,29.56455162773501
100954,2068,6,3,9,D,29.179183542696027
73658,2068,4,2,6,P,28.847641596696054
149571,2068,5,2,7,P,28.830855866054225
122538,2067,4,1,5,N,29.455280013972025
123169,2068,6,0,6,P,28.939943562841343
169932,2068,6,0,6,Q,28.77842031854009
55674,2067,3,0,3,J,29.486507600472937
103569,2068,7,2,9,E,28.855047231046985
28015,2068,6,1,7,E,28.583951547089605
115781,2068,2,0,2,P,29.11309751606804
63021,2068,3,3,6,D,29.027608046910508
148298,2067,3,1,4,M,29.221398832328383
48190,2068,6,0,6,Q,28.854170802112467
59485,2067,3,0,3,D,29.3318851417188
60846,2067,3,0,3,J,29.22481140344479
22549,2068,4,1,5,M,28.9194067720057
56790,2068,9,2,11,M,28.627801581270298
70021,2067,10,2,12,P,29.360250526100227
130093,2068,5,0,5,N,28.62622281205829
91559,2067,5,0,5,J,29.193685227399943
132900,2068,6,2,8,N,28.673571750049145
130956,2068,4,2,6,C,29.108776150251387
48387,2067,6,1,7,J,29.09129910336126
136954,2067,3,1,4,M,29.09173368026285
143956,2068,3,2,5,N,28.933678655139005
46467,2068,6,0,6,M,28.88333426044385
76629,2067,12,11,23,I,29.11937124008993
119070,2067,6,1,7,M,29.2550019208895
120742,2067,3,1,4,P,29.326232315044205
74458,2067,4,1,5,M,29.12627626513316
147340,2067,6,2,8,E,28.97971445309438
169768,2068,9,3,12,Q,28.587720357515263
185030,2068,17,6,23,P,29.047393620350157
119374,2068,5,1,6,J,28.75381316496679
100019,2067,2,3,5,M,29.28511145784033
66172,2068,5,3,8,Q,28.945104381861267
19158,2068,3,1,4,M,29.034173069504405
147335,2067,4,1,5,M,29.51713288859171
36118,2068,2,0,2,E,29.05792896500933
158492,2068,6,0,6,D,28.806013442691995
111312,2068,3,3,6,E,28.913801121843093
163548,2067,2,2,4,M,29.037396946613068
167590,2068,3,1,4,N,28.91046175003142
132738,2068,6,0,6,E,28.7496214600444
16266,2068,3,2,5,E,29.133574537769825
81261,2068,7,5,12,E,28.875719414381354
166678,2068,3,0,3,N,28.43540658210979
64317,2067,3,0,3,D,29.63455168149658
173212,2068,2,1,3,G,28.792263052203936
24986,2068,2,0,2,Q,28.733175760017676
119329,2068,4,1,5,P,28.678752112091757
115956,2068,5,3,8,E,28.76304142351088
114088,2068,3,0,3,S,28.71158988508346
121142,2067,2,1,3,D,29.34271790871657
89484,2068,6,0,6,M,28.9673470960673
166955,2068,5,1,6,N,28.552584585561057
121815,2068,6,0,6,K,29.026162809046856
92982,2067,14,1,15,N,29.31346845058119
120088,2068,20,12,32,E,29.146490505230886
68171,2068,5,1,6,E,28.489698019660118
58960,2067,4,1,5,N,29.08865231165798
81688,2068,4,1,5,D,28.757249015065643
30251,2067,6,0,6,E,29.325048764263546
106676,2068,6,0,6,P,28.49533605231287
59742,2068,2,1,3,D,28.79458837028185
68759,2067,2,2,4,Q,29.534687021195385
61138,2068,3,2,5,N,28.876337656557016
125393,2067,6,2,8,M,29.267502385210253
182871,2068,5,2,7,D,28.91244280030759
46895,2067,9,1,10,A,29.061131562084807
54803,2068,2,0,2,D,29.016661073658955
15731,2068,10,2,12,D,29.023620219519103
101533,2067,4,2,6,N,29.17203893339096
100730,2068,4,2,6,P,28.945368166800726
22626,2068,4,1,5,M,28.8134367742463
143843,2068,6,3,9,P,28.763310301673645
135728,2068,3,2,5,N,28.585007411123296
146058,2068,4,2,6,S,28.509321556751484
116104,2067,6,1,7,E,29.25756322859045
123580,2068,3,0,3,D,28.790636434365084
92031,2068,5,1,6,K,28.840415896988294
65653,2067,5,1,6,E,29.27309995451357
31724,2068,4,1,5,J,28.60690770500173
99557,2068,5,1,6,J,28.67156284560055
17528,2067,4,1,5,E,29.28749303191247
105930,2068,2,3,5,A,28.818770623777382
111188,2068,5,2,7,D,28.7388065973971
67958,2068,4,2,6,E,28.95195731085753
129746,2067,4,1,5,M,29.119606636365063
145954,2067,6,1,7,P,29.21724393133394
86809,2068,5,3,8,E,28.764251336946245
17314,2067,6,0,6,P,29.086579422769987
37922,2067,3,2,5,E,29.32262580903725
105167,2068,7,2,9,N,28.564366119947703
38282,2068,6,0,6,N,28.831532559844614
177346,2067,5,4,9,I,29.47900744479332
53422,2068,5,5,10,E,28.56791684300736
90529,2068,5,2,7,M,28.730473858741693
59633,2067,5,2,7,D,29.23580756972612
99629,2068,5,2,7,Q,28.91752259499137
111340,2068,6,0,6,K,29.01712050169443
129387,2067,3,0,3,E,29.527707438081944
114713,2068,3,3,6,M,29.024259969934217
76548,2068,4,0,4,E,29.077175278530323
148817,2068,7,2,9,P,28.705446317682405
111685,2068,1,2,3,P,28.838758724148008
172203,2067,25,3,28,N,29.014728200894027
56242,2068,3,1,4,E,28.83875435724014
110102,2068,6,2,8,K,28.55631150532989
134779,2068,6,0,6,M,28.771291764476583
139649,2068,4,0,4,N,28.93866923737144
32597,2068,5,2,7,M,29.059885080046016
174851,2067,3,2,5,N,29.12472812665837
67282,2067,9,3,12,E,29.322359837946543
157512,2068,3,5,8,M,29.014194884718417
136122,2067,5,1,6,P,29.272324614229525
127065,2067,9,2,11,P,29.205735311588157
112816,2067,2,1,3,K,28.981175526366307
91982,2067,4,0,4,N,29.303644495329443
86483,2068,4,1,5,E,28.648411517346364
148865,2068,7,1,8,P,29.10728344546116
81973,2067,3,1,4,E,28.84372973943936
160620,2068,5,0,5,A,28.944629290740224
91535,2067,3,1,4,E,29.126912006380724
138787,2068,5,1,6,Q,28.714269555378653
113638,2068,5,2,7,D,28.849463679436724
103136,2068,3,1,4,D,28.77606468077248
149249,2068,3,2,5,E,28.8958422502421
104318,2067,5,1,6,M,29.18320533582862
114176,2067,4,2,6,E,29.25357677564341
39699,2068,9,3,12,N,29.00174304589721
159647,2067,6,2,8,N,29.185817318659527
128662,2068,4,3,7,C,28.50099920716136
149488,2068,4,1,5,K,28.916859559373712
146978,2068,3,2,5,M,28.709741160957613
102329,2068,6,2,8,M,29.046871126052945
139653,2067,5,0,5,N,28.99011195342818
120371,2068,6,0,6,P,29.12336478318088
175904,2067,5,2,7,J,29.142543887857386
82188,2067,10,1,11,D,29.142712987980623
105121,2068,3,2,5,K,28.794374265938515
144967,2067,4,1,5,N,29.2989802382573
112378,2068,3,2,5,N,28.996615094647293
27355,2067,12,3,15,J,28.974552765025688
163461,2067,6,0,6,P,29.03323805817741
68532,2068,5,1,6,M,28.72762521401552
89240,2068,6,2,8,M,28.73249028917003
79401,2068,7,0,7,Q,28.910287735981058
88319,2068,2,2,4,J,29.030819715214157
33654,2068,5,1,6,D,28.74539509566858
139463,2067,4,2,6,E,29.068229201478747
98200,2068,3,1,4,E,28.404383548396808
53479,2068,2,3,5,I,28.908263504212005
104499,2068,4,2,6,E,29.29654799904497
54158,2067,6,0,6,M,29.304077789243053
170470,2067,4,0,4,A,29.238363687902822
51491,2068,4,2,6,K,28.755540562174783
143923,2067,5,1,6,E,28.97969582372005
63356,2067,6,0,6,J,29.2172877625159
102864,2068,7,8,15,F,28.692068916083937
95307,2067,3,0,3,E,29.30054642227192
56425,2067,8,2,10,J,29.00509796957088
39257,2068,2,3,5,K,28.64203142469852
93144,2067,6,0,6,I,29.452569437018468
138211,2067,3,2,5,M,28.97063724883928
158030,2068,5,1,6,E,28.91681104580315
71072,2068,4,1,5,J,28.92140219258742
137205,2067,5,2,7,J,29.253437779350055
146886,2068,5,1,6,N,28.929316225161447
122550,2067,6,0,6,S,29.13662234264691
122895,2068,7,2,9,P,28.99941159465738
2556718,2067,16,2,18,P,29.05242723226962
102316,2067,1,2,3,D,29.14348757948904
142499,2068,5,1,6,C,29.409081032203787
34190,2068,5,1,6,Q,28.800254908965165
96109,2067,3,1,4,N,29.234925026490668
50904,2068,6,1,7,S,28.47696412537483
135892,2068,6,1,7,E,28.933511039506055
28091,2067,5,1,6,Q,29.152246188945885
117029,2067,7,1,8,A,28.85122323080336
171760,2068,6,0,6,Q,28.773443453502825
62239,2068,5,2,7,P,29.155895933622784
168359,2068,2,3,5,P,28.49226849347009
140018,2067,4,1,5,M,29.26078616556178
28878,2068,5,0,5,J,28.81268946895973
82316,2067,3,0,3,E,29.38295000464493
145983,2068,5,2,7,M,28.718519285840475
54596,2067,2,2,4,M,29.21071140066389
127059,2068,4,1,5,S,29.020629656668
156361,2068,2,1,3,N,28.70188984788376
182336,2068,3,3,6,J,28.876757919543586
73397,2068,2,2,4,K,29.09291630908792
82888,2068,4,1,5,H,28.91857277255516
64928,2067,4,0,4,D,29.331665647429197
144277,2068,4,3,7,M,28.64255209006447
92904,2067,11,2,13,J,28.84995178157721
176964,2067,3,2,5,C,28.97273638722927
144804,2067,4,0,4,P,29.441667484740474
161461,2068,5,3,8,E,28.80822450946677
49306,2068,5,2,7,S,28.86090048876961
168227,2068,6,2,8,N,28.70145851991732
174854,2068,3,1,4,J,29.300356982559396
78463,2067,5,0,5,P,28.845237564106878
61330,2068,6,0,6,D,28.70818071510975
21332,2068,8,1,9,P,28.959331799849508
31554,2067,7,1,8,L,28.79628919555099
83254,2067,3,0,3,H,28.916462946568828
122436,2067,3,3,6,J,29.032281699307507
175893,2067,5,4,9,D,29.282634828216214
110351,2068,4,1,5,K,28.712853991076123
147651,2068,6,1,7,M,28.988060130343506
61042,2067,3,2,5,N,28.92726015657037
115457,2067,5,0,5,E,28.960524893006166
87614,2067,6,1,7,J,29.168394484571277
30410,2068,5,1,6,E,28.80612495802464
156414,2067,3,2,5,N,29.068219232306507
115030,2067,5,1,6,P,28.889496255296137
149305,2068,6,0,6,K,28.97892629618901
96671,2067,4,0,4,N,29.07578635085751
147665,2068,5,2,7,N,28.85257611549297
97365,2068,9,3,12,N,28.8434436675432
138380,2067,4,1,5,P,29.00869911293412
44885,2067,10,0,10,A,28.95208271294364
50517,2067,5,1,6,Q,29.155757386181364
70457,2068,3,2,5,P,28.94387071061704
139491,2067,2,0,2,F,29.25013912036129
24196,2067,7,2,9,E,29.11424272972196
27461,2067,14,6,20,D,29.365758467566184
106744,2067,2,2,4,S,29.49899300453975
101806,2067,4,1,5,Q,29.016519682129296
163232,2068,6,3,9,N,28.822200200006176
69451,2067,8,2,10,H,29.092857577563677
66183,2068,5,0,5,P,28.94814707278284
38994,2068,6,2,8,R,28.732778613106653
148636,2068,6,2,8,Q,28.7030095381292
112022,2067,16,2,18,H,29.21933632213033
25514,2068,7,1,8,Q,28.965749647212004
140901,2067,2,2,4,E,29.220737720520496
66755,2068,2,1,3,N,28.90574803102107
142721,2068,4,1,5,E,28.856344274103478
59469,2068,4,2,6,N,29.077289206964675
157935,2067,3,3,6,E,29.07547223430033
129852,2067,6,2,8,E,29.21643651914127
158656,2068,5,3,8,A,28.863146324563907
166754,2068,6,0,6,J,28.84003838511335
32679,2068,3,1,4,E,28.99626774420677
41548,2067,2,1,3,F,29.105991196255445
25581,2067,2,2,4,C,28.60162265006691
100875,2067,4,1,5,N,29.20042015870776
114041,2068,4,2,6,E,28.93157596100279
92090,2067,2,3,5,N,29.03833657522583
167010,2068,6,0,6,Q,28.92505736427864
128829,2067,4,1,5,P,28.91046489862976
140019,2067,6,1,7,Q,29.17842198302533
159754,2067,6,2,8,P,29.11196374179271
131076,2068,2,0,2,J,28.842994419361823
112949,2068,3,1,4,E,28.822583339371874
16943,2067,2,2,4,M,29.0092843868183
145744,2067,2,0,2,M,29.52695695441451
89518,2068,5,2,7,E,28.897800720655688
71459,2068,4,2,6,P,29.067244712647263
125542,2068,4,2,6,P,28.850443457287348
76973,2068,8,2,10,E,29.166564735169864
135367,2067,5,3,8,A,29.292620523865857
156220,2068,8,0,8,Q,28.866774981172178
66135,2068,13,3,16,A,28.70783054355931
156497,2067,6,0,6,E,29.31740833533399
82409,2067,3,1,4,Q,29.353725548298826
38072,2067,7,2,9,Q,29.545351539706907
60413,2068,3,1,4,N,28.948698849065856
162802,2068,3,2,5,E,28.72425054714267
82781,2067,3,1,4,N,29.15311097142184
180905,2068,4,1,5,D,28.73571650980297
176261,2068,6,0,6,P,28.654566694641165
147042,2067,4,1,5,M,29.085744638581588
66942,2068,6,1,7,S,29.09642954943359
177763,2067,3,2,5,P,29.14050759400504
142065,2068,4,0,4,K,29.13428609996279
17110,2067,5,3,8,P,29.11237276110648
169932,2067,2,1,3,Q,29.177590903406948
185037,2067,10,3,13,P,29.078327139796603
122355,2068,2,1,3,P,28.85048974495132
104573,2067,6,2,8,S,29.25078792319177
24946,2067,3,1,4,M,29.020176724977222
120000,2067,9,0,9,E,29.363638243528367
46746,2067,3,1,4,E,29.31359226524465
95784,2068,4,1,5,E,29.04378969976149
46698,2068,2,0,2,E,29.261128773175344
156693,2068,8,3,11,N,28.415874877419647
106287,2068,3,0,3,E,28.7901429677485
32600,2067,5,0,5,Q,28.96784286426768
158610,2068,4,1,5,J,28.955729597640705
129282,2067,6,0,6,M,29.31325179024925
169986,2067,3,0,3,D,28.935335299731165
88494,2067,3,1,4,E,29.423327872593827
75371,2067,2,1,3,M,29.36459404297469
16059,2067,5,0,5,Q,28.738161483063077
95105,2068,6,0,6,N,28.361958833694985
73729,2068,4,1,5,K,28.786867647750103
143128,2067,5,2,7,P,29.086104945731705
112791,2067,6,0,6,Q,29.02239172497004
143638,2067,5,3,8,Q,29.41287679407972
63815,2067,6,0,6,A,29.1886880202551
76865,2068,1,2,3,M,29.02794953826072
95595,2067,4,5,9,E,28.848489837324625
15863,2068,6,0,6,P,28.6771814075934
59934,2068,6,0,6,Q,28.83076275275037
133739,2068,5,2,7,N,28.775071826712004
22384,2068,5,4,9,M,29.21403677610813
81425,2068,3,1,4,C,28.833466737737336
113721,2068,5,2,7,E,28.825178956561267
67777,2067,6,2,8,E,29.180452582905826
115234,2068,4,1,5,E,29.158476893981973
15959,2068,6,1,7,D,28.918288244047588
68684,2068,6,3,9,D,28.88826146014909
61919,2068,2,3,5,J,28.98292160009221
135024,2068,3,3,6,J,28.460187093717327
29774,2067,5,0,5,K,29.13152443321731
95370,2067,6,1,7,N,29.473982782165905
123926,2068,5,0,5,P,29.138432267201534
20182,2068,6,0,6,E,29.10072463562957
111066,2067,6,0,6,N,28.87574122658496
117413,2068,3,2,5,N,29.13121067837757
63260,2067,7,0,7,Q,28.89347990744065
139973,2067,5,2,7,S,29.177101273053538
104996,2067,5,2,7,A,29.22057833180667
148589,2067,6,2,8,J,29.07923478528151
111161,2067,3,1,4,K,29.30692199955228
113762,2067,5,2,7,E,29.347651707928737
72528,2067,4,2,6,J,29.24927287440905
95139,2067,3,2,5,E,29.49168927721404
53287,2068,4,2,6,N,28.933776169430967
149566,2068,4,1,5,P,28.778100719613693
159497,2067,3,2,5,N,28.78654162298529
141357,2067,4,3,7,P,29.08034707052324
61960,2068,2,2,4,J,29.02394059773989
100613,2067,3,2,5,P,29.17111044630089
38164,2067,5,1,6,J,28.923255984630103
182797,2068,9,1,10,P,28.845807280157324
178731,2068,3,0,3,N,28.538494650682058
25479,2067,3,1,4,Q,29.53298993880233
161670,2068,7,2,9,H,29.10606756641018
41242,2067,8,1,9,Q,29.491335363629016
142630,2067,3,3,6,J,29.38743166040604
142524,2067,5,3,8,P,29.080666086912554
117021,2068,3,1,4,K,29.017188429802037
29308,2068,2,2,4,K,28.886928018470204
61383,2068,1,2,3,S,28.81735080987473
53271,2067,4,1,5,Q,29.103380649418437
113945,2067,4,1,5,M,29.380386348717213
121043,2067,4,0,4,N,29.177859546724704
19676,2068,2,0,2,E,28.65848644552314
78181,2068,6,2,8,P,29.30830606366984
62446,2068,8,2,10,J,28.977685331668564
183129,2068,3,2,5,M,29.11648438898196
182486,2067,1,3,4,A,29.29341451532537
31451,2067,3,2,5,J,29.49461053151453
142091,2068,2,2,4,S,28.779484907826365
66215,2068,26,4,30,E,29.180988640045896
163958,2067,6,2,8,E,29.220626963517823
22389,2067,5,2,7,K,29.284493246374005
138090,2067,3,0,3,E,29.13055447043108
63371,2068,6,0,6,E,29.11456703537794
27791,2067,5,1,6,E,29.238393032244737
167801,2068,6,1,7,Q,28.758512764402287
36402,2067,6,1,7,Q,29.29234015138632
180786,2068,3,2,5,M,28.502152334515795
159124,2067,5,1,6,E,29.218983123740102
139068,2068,5,1,6,M,29.098409954878544
157987,2068,3,1,4,J,28.85191133255691
77407,2067,4,2,6,K,29.469501633806704
136466,2067,5,2,7,N,29.16568959020459
123527,2068,4,2,6,F,28.80627472210083
120067,2068,4,2,6,N,28.43717794654627
122128,2067,5,3,8,E,29.32323364056497
160300,2067,6,1,7,M,29.133232936255965
134807,2068,3,2,5,J,28.7097319090694
146740,2068,6,1,7,N,28.783658640009765
53102,2067,6,2,8,M,29.448545669687185
123388,2067,1,1,2,E,28.85815421192496
107649,2068,3,0,3,E,29.143467358677885
22139,2068,5,2,7,Q,28.90192839612152
141498,2068,6,0,6,E,28.5795034475492
135406,2067,3,1,4,D,29.400099254615547
73084,2068,2,1,3,M,28.804859822682623
167557,2067,3,2,5,M,29.31911639777336
150288,2068,3,2,5,M,28.730987553025383
50641,2068,6,0,6,N,28.848962119025405
52429,2067,4,2,6,E,29.258576853854848
22139,2067,4,1,5,Q,29.10576159149639
31027,2067,3,0,3,Q,29.32569150811487
158574,2067,9,2,11,Q,29.08607251535129
138756,2067,5,1,6,D,29.036033531849867
27778,2067,3,0,3,Q,29.136794715579335
166976,2068,6,1,7,M,28.86969477190955
121370,2067,2,2,4,N,28.998376734237866
31108,2068,1,3,4,N,29.064880691442067
134343,2068,7,1,8,Q,29.129384534010885
147408,2067,4,0,4,M,29.061895756973044
121446,2067,2,2,4,J,29.43381416152604
146535,2068,6,2,8,J,29.0850388343928
55473,2068,3,1,4,P,29.1589602137762
145641,2068,8,0,8,K,28.74664370290391
145480,2068,3,2,5,M,28.76762970887184
136210,2067,1,1,2,K,29.314508890426584
61479,2068,12,1,13,J,28.60016474943776
53468,2068,7,1,8,S,28.750498011547585
118089,2067,5,2,7,J,29.3752273856188
64241,2068,7,0,7,H,29.15407415867265
106504,2068,5,0,5,E,28.697566850754093
42345,2068,5,0,5,N,28.6272178427689
145586,2067,5,1,6,M,29.62603683191803
180468,2068,6,0,6,A,29.181739103261545
113914,2068,7,2,9,J,28.916014475603
163138,2068,5,2,7,P,28.78202656126596
108812,2068,4,0,4,J,28.62262241073212
78866,2068,4,0,4,K,28.61102425455
122850,2067,7,3,10,P,29.082775321326384
149439,2068,7,2,9,M,28.847612889120807
60336,2068,4,2,6,D,29.10533816198738
23398,2068,3,2,5,Q,29.002112609160665
21349,2067,4,1,5,D,29.427111665338675
134930,2067,4,2,6,M,29.44986721832504
82401,2067,3,2,5,E,29.211755644186876
185034,2068,8,5,13,P,28.8411660275592
18606,2067,6,1,7,Q,29.248875479493577
45906,2068,4,3,7,F,28.743656334071748
61545,2067,4,2,6,H,29.277820313366032
24329,2068,4,1,5,D,28.973027213187475
32597,2067,2,2,4,M,29.30791516899769
127580,2067,4,2,6,E,29.15105855903746
104991,2067,4,1,5,M,29.17878629673815
171564,2068,6,0,6,J,28.86171477478077
103692,2067,5,2,7,N,29.387889380148557
85158,2067,4,3,7,E,29.22806662536564
172256,2068,3,0,3,D,29.098093049038223
116167,2068,6,2,8,K,28.311247546758675
158775,2068,7,1,8,N,28.895609374532853
24715,2067,3,2,5,J,29.34950200184413
22315,2067,5,0,5,M,29.610933506645985
182797,2067,10,1,11,P,29.239985719824936
70735,2067,3,0,3,M,28.996814749053915
67781,2068,3,2,5,D,28.54923998892936
171639,2068,1,1,2,E,28.74832165693729
60658,2068,12,6,18,D,29.02911005607589
60484,2068,5,0,5,Q,28.8077023333947
59449,2068,7,4,11,E,28.772380638344774
85081,2068,11,0,11,M,29.007986466959416
62018,2068,3,0,3,N,28.91216336355773
81964,2068,2,1,3,Q,28.836851056727934
114951,2068,5,3,8,E,28.755917212315342
141181,2068,7,2,9,Q,28.574595949701607
130901,2067,3,3,6,M,29.442904957762543
175660,2068,5,0,5,N,28.81539625499292
112066,2068,6,1,7,M,28.92434508130865
156867,2068,3,1,4,N,28.6459107297834
94879,2068,4,0,4,N,28.75845471747509
88075,2067,4,2,6,E,29.11500266054422
159329,2067,2,0,2,M,29.50286088705065
114230,2067,5,1,6,J,28.94717455842193
125380,2068,5,3,8,E,28.708291873068397
109810,2068,6,3,9,E,28.68853089537976
89491,2067,4,0,4,P,29.15251684626572
57348,2068,7,2,9,N,29.117693318383512
119600,2067,2,2,4,E,29.19649938075784
116221,2067,6,3,9,N,29.25328222486263
38535,2067,7,1,8,S,29.074508574830134
150773,2068,2,3,5,N,28.703527327105498
129956,2068,5,0,5,N,29.26562342378146
33916,2068,12,6,18,E,29.08362893122534
107174,2067,3,1,4,N,29.09106990263605
61500,2067,3,1,4,E,29.410657797814043
135318,2067,6,0,6,E,29.35722836289619
139839,2068,1,2,3,P,28.946341908940216
91597,2067,6,2,8,E,29.08618701429028
114781,2067,2,1,3,J,29.399012919748326
47691,2068,3,5,8,P,28.93721776730669
100857,2067,1,2,3,J,28.94536652366196
72689,2067,2,1,3,D,28.93954678923496
33170,2068,6,2,8,E,28.65273306309152
159080,2067,7,1,8,E,29.12336353449044
64884,2067,9,2,11,E,29.336306630286963
178559,2068,7,2,9,P,28.779691127633463
25596,2068,5,3,8,J,28.63256134184933
26988,2068,4,2,6,P,29.27789393954291
140240,2067,9,0,9,J,29.298019165658054
31298,2068,3,1,4,M,28.90263480761265
74673,2068,8,1,9,J,28.907581479612197
130909,2068,3,2,5,E,29.084968409883537
17915,2068,3,1,4,D,28.70979198418377
45461,2067,8,2,10,K,29.260268923911436
173759,2068,5,3,8,P,28.665088470134904
63022,2067,4,2,6,E,28.859251681617405
121170,2067,5,1,6,P,29.00718237537973
88707,2068,3,1,4,M,28.651933000648597
111897,2067,5,0,5,E,29.531711305775648
144110,2067,4,1,5,Q,29.03682116000653
175687,2067,2,2,4,I,29.24110563386552
148889,2067,6,3,9,M,29.49736760441938
61582,2067,2,1,3,E,29.088927031828444
107065,2068,3,2,5,F,29.240336105719603
116866,2068,2,2,4,J,29.07900489972352
148850,2068,3,0,3,P,28.94044756158577
74084,2067,6,1,7,Q,29.277056978222145
77517,2067,3,2,5,K,29.223897851397435
172896,2067,4,0,4,J,29.48858807397854
27923,2067,8,1,9,P,29.347397789412835
51622,2068,1,3,4,N,28.816057288943995
135738,2068,4,3,7,J,28.83250228391023
22548,2068,5,0,5,G,28.949147347125955
150325,2068,7,1,8,P,28.85548840802184
39040,2067,4,2,6,Q,29.03382925571184
134784,2067,6,1,7,E,29.162572272685296
90250,2067,6,2,8,Q,29.009222726297068
108895,2068,5,1,6,P,28.85520920363524
164185,2068,3,2,5,E,29.19058483388672
26392,2068,8,2,10,H,28.84922267366245
159744,2068,5,2,7,E,28.718484207582552
102058,2067,4,0,4,E,29.467175883864243
144609,2067,6,1,7,M,29.16339017392685
103379,2068,5,2,7,J,28.962554076139707
173980,2067,3,3,6,E,28.991101589691837
182412,2067,4,3,7,N,29.22749860264445
161188,2067,4,0,4,N,29.30238138439504
120203,2067,5,0,5,A,29.00964041802624
171955,2068,3,2,5,N,28.76665625960765
157847,2067,6,2,8,J,28.73392860900951
50980,2067,3,0,3,S,28.83421006396195
61652,2068,7,2,9,N,28.740751226271897
48582,2067,3,2,5,N,29.50312558590696
125108,2067,4,2,6,E,29.218227889361344
117728,2067,3,3,6,E,29.335961025803527
105123,2068,5,0,5,E,28.96443982852392
173360,2067,5,0,5,R,29.169188610716606
28645,2068,6,1,7,K,28.866111132855075
134944,2067,7,1,8,S,29.27365443773117
104512,2068,6,0,6,S,28.99746638013781
100091,2067,0,3,3,N,29.10303093939235
82194,2068,12,0,12,A,29.12404400484829
18176,2067,6,1,7,Q,29.20954365618097
134616,2067,4,1,5,M,28.82808360702992
102346,2067,4,3,7,K,29.29379638594789
158061,2068,0,2,2,N,28.643161526685667
134893,2068,5,2,7,Q,28.720515078243043
61407,2067,6,1,7,D,29.00652775922216
73231,2068,1,2,3,N,28.81487780750865
19317,2067,5,3,8,Q,29.087561046169245
24335,2068,1,2,3,A,28.897375963074595
93906,2068,2,0,2,N,29.03888684275668
157438,2067,5,2,7,N,29.067196161655747
132889,2068,3,0,3,S,28.784207197422976
124317,2067,5,0,5,J,29.39062627799225
51105,2068,6,0,6,E,28.85177550222835
181958,2068,4,1,5,K,28.802710558572613
64118,2068,2,0,2,N,28.847438083362743
113488,2067,6,1,7,M,29.07689133663424
15852,2068,2,1,3,J,28.711188311770368
28300,2068,3,1,4,N,29.131632906491816
165238,2067,2,3,5,J,29.276769303611164
156562,2067,7,3,10,N,29.442008583766697
120271,2068,4,0,4,Q,28.79880872251524
75474,2067,6,0,6,E,29.258477498074143
75574,2067,6,0,6,N,29.16727445197184
141971,2068,6,3,9,C,29.002061016437395
123713,2067,5,1,6,P,29.113985728918426
115632,2067,3,0,3,E,29.091936944738517
46133,2067,6,2,8,Q,29.12567698248141
181413,2067,4,0,4,Q,29.270026990874157
61581,2068,1,3,4,E,29.04706075589012
124913,2068,4,1,5,K,28.79823307478699
54054,2067,5,2,7,J,29.102970333761583
49019,2067,4,3,7,S,29.248234733450737
169258,2068,8,3,11,J,29.05192611954687
140656,2068,7,1,8,D,28.796093310163187
113107,2068,7,0,7,H,28.94830686357351
85515,2067,6,1,7,P,29.437405075505016
84519,2067,2,3,5,J,29.270067031756284
163029,2068,3,2,5,E,28.774868498741625
39035,2068,6,1,7,E,28.66092740146713
127660,2067,7,1,8,Q,29.194432357818474
24837,2068,9,4,13,M,28.987797315122663
91619,2067,7,1,8,D,29.20291339480939
29806,2068,6,0,6,Q,28.91346031956091
121275,2067,6,1,7,K,29.09604983018643
71015,2067,7,2,9,K,28.792991142328184
157614,2067,2,0,2,R,29.59298863146389
138873,2068,1,1,2,J,28.954234659586056
56683,2067,4,0,4,M,29.385091096596707
109625,2068,6,1,7,K,29.128965298226948
131762,2067,4,0,4,J,29.32328555588774
25737,2067,6,2,8,J,29.230409974917837
20853,2067,4,2,6,J,29.386405050328392
168332,2068,5,1,6,M,28.651114814518102
61729,2068,13,3,16,P,28.832150193047884
34266,2068,7,1,8,K,29.119020690865646
68040,2068,12,3,15,E,28.955008830864664
35576,2068,7,3,10,E,28.82863726376922
45178,2067,10,2,12,A,29.002130477551404
124325,2068,5,0,5,E,28.875921392992968
54193,2067,2,2,4,S,29.550410435080977
56396,2067,7,0,7,K,29.092547588632243
171079,2068,3,2,5,E,28.81644792868141
120741,2067,4,0,4,N,29.068995920537212
101830,2068,2,2,4,J,28.84541709968165
45101,2067,3,3,6,E,29.006925161062615
68401,2068,10,0,10,E,28.94450886017994
63616,2067,3,3,6,I,29.15734686108111
144283,2068,4,1,5,N,28.96919066816326
172102,2067,8,1,9,D,28.787407857861016
175870,2068,6,0,6,E,28.902042584641364
17119,2068,5,1,6,P,28.64678706486077
61688,2068,2,1,3,J,29.18172555060877
89169,2067,6,2,8,D,29.213375985046863
62676,2068,8,2,10,E,28.675514552186204
89750,2067,6,2,8,Q,29.23175492055632
182613,2067,7,3,10,E,28.94154684272716
41256,2068,2,2,4,D,28.856694608950026
124677,2067,3,1,4,E,29.01662445277065
165787,2067,2,1,3,M,29.07342981390975
41387,2067,7,0,7,J,29.3052383674235
125240,2067,5,2,7,J,29.32307834081905
48312,2067,7,3,10,A,29.114088218129968
150352,2068,3,1,4,M,28.67651727185158
41019,2067,2,1,3,J,29.23196479402127
116811,2068,5,0,5,K,29.140264742978285
114333,2067,5,1,6,J,29.202992618588777
144389,2067,3,1,4,J,29.06229944508793
90144,2068,7,2,9,K,28.963346352350317
39850,2067,4,2,6,S,29.020216304743748
169568,2067,6,0,6,D,29.374977205978052
95062,2067,7,2,9,N,29.307397799042004
145689,2068,7,2,9,S,28.812282736093835
15897,2067,3,2,5,M,29.341537710620337
119363,2067,6,2,8,K,29.06895181246242
23591,2067,1,3,4,N,28.849373839030235
147551,2068,6,1,7,P,28.896451193881035
78922,2068,7,0,7,P,28.70279891901144
77476,2068,6,1,7,E,28.665962834610024
59172,2067,4,2,6,Q,29.357495744186952
94640,2068,5,2,7,N,28.899499692487478
68113,2067,2,1,3,D,29.183249440176105
148852,2067,5,0,5,N,29.13926161336101
16529,2068,1,3,4,P,28.82837847468884
180008,2068,10,3,13,P,28.56338748665997
170262,2067,4,2,6,J,29.20924753821247
169307,2068,3,3,6,N,28.697758059972543
100727,2068,5,2,7,J,28.634565270797545
67077,2068,8,4,12,P,28.63945162970979
31962,2067,3,1,4,G,29.43626919551181
107794,2067,3,3,6,P,29.31850901687865
111232,2068,5,3,8,E,28.937727693546805
23934,2067,6,3,9,J,29.09626119941484
117674,2068,3,1,4,E,29.232066302556134
17138,2067,1,2,3,E,28.94817917902221
146293,2068,7,2,9,M,28.97396385197371
16924,2068,2,2,4,P,28.724456490184124
109911,2067,2,2,4,J,29.12149860541117
96340,2068,5,2,7,E,28.808398701482613
28372,2067,8,2,10,E,29.256825206063816
65895,2067,4,0,4,M,29.06936201669109
157087,2067,3,2,5,E,29.135100578711704
173980,2068,4,3,7,E,28.516923371351385
42128,2068,5,0,5,E,28.94532072505528
52163,2067,1,3,4,E,29.520322024694604
29693,2068,2,2,4,K,28.740333108282783
144654,2068,7,0,7,M,29.10129617513356
82696,2067,5,0,5,R,28.9991117938569
148414,2068,4,3,7,M,28.59325772599285
50629,2067,5,0,5,N,29.25127299994829
90472,2067,3,0,3,D,29.460495970253035
36370,2068,3,0,3,P,29.057862414176192
140804,2067,4,2,6,M,29.24391286840257
63672,2067,2,1,3,M,29.216321894005933
142248,2067,4,2,6,M,29.025873463898773
107989,2067,4,0,4,D,29.012466425540403
87323,2067,2,0,2,E,29.345902879540606
109150,2067,4,3,7,E,29.24302157665224
28753,2068,4,1,5,D,28.981891794224765
162783,2067,2,1,3,E,28.98977267396188
56303,2067,1,2,3,E,29.53784434258396
86210,2067,1,4,5,Q,29.170591332388327
62210,2067,3,2,5,N,29.286476136456965
183015,2068,3,1,4,M,28.78472978047742
51667,2067,3,2,5,E,29.15081998512888
98417,2067,3,2,5,D,29.36184219509109
119380,2068,7,1,8,E,28.7745770268484
19797,2067,4,1,5,M,29.11233033493669
46160,2067,15,3,18,A,29.547386949356824
105722,2067,3,2,5,M,29.394395957479446
86992,2067,1,2,3,P,29.499956233744303
156693,2067,6,3,9,N,29.292611058431085
18247,2068,1,2,3,N,28.756532303404168
114176,2068,6,0,6,E,28.999809298614476
119070,2068,5,1,6,M,28.6616146201387
66521,2068,2,3,5,E,28.683749545082744
158135,2067,3,0,3,N,29.39174317176121
47024,2068,5,1,6,N,28.978137213571888
44550,2068,2,2,4,E,28.883292970155697
125022,2067,4,2,6,S,29.327779026723185
78603,2067,3,1,4,S,29.64537525385112
24516,2067,4,5,9,A,29.382969154659005
144270,2068,7,0,7,D,28.93082007442205
117630,2068,4,2,6,D,28.787703588893223
104620,2068,5,0,5,I,29.1056959787278
139624,2068,1,1,2,I,28.68187630027808
74051,2068,6,1,7,N,28.644034666042625
56815,2068,4,2,6,E,28.732066393536147
47992,2067,4,2,6,Q,29.177711228910404
24716,2068,5,1,6,D,28.83125644616829
72479,2067,5,3,8,J,29.227643514267903
167327,2067,10,2,12,M,29.23512414683491
101658,2067,6,1,7,E,29.274956517605958
175576,2067,5,3,8,E,28.977136655093588
142096,2067,7,1,8,Q,29.401026273061948
139229,2068,5,1,6,E,28.78684355976505
77531,2068,4,1,5,N,28.675481646842677
97280,2067,5,2,7,E,29.09635038197209
179691,2067,8,0,8,Q,29.36815572138129
110477,2068,7,1,8,E,28.86750857034356
44957,2067,5,1,6,E,29.42664491474173
26868,2067,6,2,8,P,29.254603270731995
40632,2068,2,2,4,Q,28.71551909576517
46891,2067,3,1,4,D,29.06477339688904
130247,2067,6,0,6,M,29.015483024977133
121760,2068,6,0,6,J,28.78862493944246
122559,2068,5,0,5,K,28.580752403216536
122095,2068,7,2,9,E,28.8586728327838
71229,2068,6,1,7,N,28.80292614604851
82708,2068,2,2,4,N,29.088276792100256
59301,2068,3,0,3,P,28.691512507333925
124814,2068,2,0,2,S,29.10275783872757
109576,2067,2,1,3,K,29.50342316716925
50591,2068,3,3,6,C,28.713556460453397
125036,2068,3,0,3,E,28.992217208542247
53422,2067,4,3,7,E,29.13159955948648
22339,2067,7,0,7,M,29.29965901698872
129748,2068,5,0,5,I,28.69590936300531
137036,2068,7,1,8,M,29.052877504138007
89377,2068,3,2,5,E,28.756594334149955
54725,2068,3,0,3,N,28.96100278327951
16005,2068,4,0,4,A,28.689474311607427
19507,2067,7,1,8,N,29.15635398453327
23543,2068,6,1,7,D,28.97868572749352
111418,2067,4,1,5,J,29.40127956181097
106488,2068,1,1,2,M,28.76574195630764
145764,2068,4,0,4,E,28.928430244246776
108626,2068,2,0,2,Q,28.784396882750265
33912,2068,6,1,7,P,28.68410012599205
73547,2068,5,1,6,M,28.922250051716883
54113,2067,4,0,4,N,29.031183866198926
91714,2068,4,3,7,N,28.941580378171345
98096,2068,7,0,7,J,28.646877670068047
136959,2068,3,2,5,M,28.9687876623828
55962,2068,5,2,7,N,28.6508473513269
106422,2067,2,2,4,J,29.373379655732894
164138,2068,1,3,4,P,28.644925877823106
19558,2068,3,0,3,K,29.009107433657668
171327,2067,2,3,5,E,29.21078419610452
87655,2068,3,3,6,K,28.979602679546392
112559,2068,4,0,4,P,28.729048188455792
39678,2068,7,1,8,S,29.06598406648617
171378,2067,2,2,4,D,29.198540877317924
68237,2068,3,1,4,I,28.769046726466065
87262,2067,4,2,6,Q,28.71866670666393
111431,2067,4,0,4,E,28.93047539611288
94463,2067,2,2,4,D,29.037147851289937
21812,2067,4,2,6,J,29.17043001183528
32991,2067,5,0,5,E,29.123169628095628
135865,2068,4,2,6,J,28.69554269646792
19091,2067,12,1,13,H,29.39810318885993
148137,2068,3,0,3,S,29.1739702151084
135508,2068,6,1,7,S,29.106244969545934
177626,2068,1,1,2,M,29.12677764378064
68342,2067,2,1,3,N,29.10049670318229
140825,2068,3,3,6,P,28.72005289705082
70925,2067,3,2,5,N,29.05012799722057
58786,2067,2,0,2,Q,29.23422845392302
55102,2068,3,2,5,J,29.17327597577348
149299,2068,6,1,7,M,28.961198602043417
110968,2067,6,0,6,P,29.12652728980341
145511,2068,4,2,6,M,28.751465134887745
25668,2067,6,0,6,D,29.439939266598195
83282,2067,8,0,8,Q,29.350774958041388
20531,2068,5,3,8,E,29.163907139343014
77358,2068,3,3,6,E,28.5509939344646
85198,2068,5,2,7,E,29.05525923469345
20187,2067,2,1,3,M,29.41347185592995
32418,2067,8,1,9,J,29.43961354372373
108849,2067,2,5,7,Q,29.38343409651815
54439,2068,4,1,5,P,28.674703383554988
149785,2068,5,0,5,N,28.85455175515697
134364,2067,2,0,2,P,29.252952903476007
130682,2067,6,0,6,P,29.34535960569009
38645,2068,3,2,5,E,28.684643530641186
145142,2068,6,0,6,P,28.916810005308847
174123,2067,10,1,11,F,29.27098236964234
143515,2068,6,4,10,E,28.757980848003328
102573,2068,5,1,6,P,28.4657541134722
74160,2067,2,0,2,D,29.13594519586368
24196,2068,7,1,8,E,28.63774560732127
129449,2067,2,3,5,M,29.16472281116308
148955,2067,8,1,9,C,29.18348574995572
158455,2068,5,2,7,E,28.83501854579008
29377,2068,8,3,11,A,28.732509700814347
61305,2067,2,1,3,Q,29.028725091770117
92528,2067,3,2,5,J,29.4693978674293
173828,2068,8,1,9,D,28.71244472447261
41046,2067,3,2,5,J,29.07399559415052
48361,2067,4,0,4,K,29.012334907008004
138522,2068,5,2,7,M,28.69455392040177
95377,2067,2,3,5,N,29.12557578258065
118496,2067,2,3,5,K,28.941169082563047
31141,2067,6,0,6,M,29.324659246099152
88238,2068,2,2,4,N,28.50202376833842
38535,2068,5,2,7,S,29.15023494223845
143709,2068,3,2,5,N,29.009724285588167
103246,2068,6,0,6,J,28.69115259828423
36007,2068,5,0,5,D,28.597695452552365
120152,2067,4,1,5,Q,29.005863837140616
107315,2068,5,2,7,N,28.733177882203023
64635,2068,1,1,2,N,28.722259229533595
137368,2067,5,1,6,M,29.31285971605009
128637,2067,5,1,6,K,29.33587665728188
23759,2068,3,1,4,N,28.75814548753453
168109,2068,5,0,5,N,29.015589835407106
44885,2068,13,0,13,A,28.784122821317435
111416,2067,4,1,5,M,29.41109059200143
98149,2067,3,0,3,Q,29.400922456836764
35295,2068,6,0,6,E,28.55761044741657
44837,2067,6,3,9,J,29.200737877471397
101672,2067,6,1,7,E,29.14099491003008
67794,2068,3,0,3,P,28.840822463577297
92740,2067,2,2,4,E,29.234807593605776
157487,2068,0,3,3,N,28.98069251886348
108237,2067,5,1,6,E,29.109138934733306
15874,2067,1,3,4,P,28.875115769824436
181912,2067,4,2,6,Q,29.15062641556258
130429,2068,4,1,5,P,28.813558113250657
111209,2068,6,0,6,E,28.985094849780342
146878,2067,6,3,9,M,29.222342336026795
158146,2068,4,1,5,E,28.683882214329063
44553,2068,4,1,5,E,28.572670141018065
114747,2067,8,5,13,E,29.16925813046764
111262,2068,5,1,6,K,29.126414191670296
145450,2067,5,1,6,M,29.144722129037778
108605,2068,3,2,5,E,28.852126942233717
166598,2068,7,3,10,P,28.900702319133924
93877,2067,3,2,5,E,28.93818105047751
78385,2067,5,1,6,N,29.04358530290505
162073,2067,3,0,3,A,29.1218962148123
147338,2067,4,2,6,F,29.186278400432307
138926,2067,4,4,8,N,29.1913977657091
132853,2068,5,2,7,D,28.79131792507477
51558,2068,4,1,5,K,28.803158862762736
99992,2068,5,3,8,J,28.452669231596605
19431,2067,6,3,9,I,29.440103700871127
81207,2068,6,0,6,D,28.626104895502287
53811,2067,5,1,6,Q,29.409033751900747
81976,2067,4,0,4,N,29.04658070516664
124060,2067,1,2,3,J,29.103341840020125
17867,2068,3,2,5,D,28.92222124502576
62621,2068,8,2,10,Q,29.259816388541022
134945,2067,6,1,7,P,28.995947243581973
37322,2067,10,3,13,J,29.21141756001429
24134,2067,4,0,4,D,29.19681066461803
40532,2068,3,1,4,K,29.05598366190337
21027,2068,2,1,3,N,28.58755893679845
137084,2068,4,2,6,P,28.860665264411686
144269,2067,6,0,6,D,29.349686665247415
28393,2068,3,1,4,D,29.384974723200063
18830,2068,3,1,4,N,28.879926093175857
93305,2067,3,2,5,E,29.232840306363485
113703,2068,3,2,5,Q,28.733597149977648
178476,2068,4,2,6,M,28.71491918015917
110248,2067,2,0,2,E,29.05856750725477
92269,2067,3,1,4,E,29.347642442581723
88126,2068,7,1,8,K,28.96940360042113
83262,2068,2,0,2,N,28.95530117939226
95669,2068,6,2,8,N,28.78144431010535
145527,2068,2,3,5,A,28.66602430434995
41180,2067,2,1,3,N,29.142445830617984
112749,2068,5,2,7,E,28.805842373887284
27608,2068,2,2,4,Q,28.60123005902296
92888,2068,5,0,5,N,28.58249412138759
72199,2067,3,2,5,E,28.987941819713686
156195,2068,5,2,7,N,28.807319529742045
27977,2068,4,2,6,K,28.58026737852904
67416,2068,2,0,2,E,28.720849572644543
111922,2068,7,0,7,J,29.03065015190577
83835,2068,2,2,4,P,28.55649440320516
120609,2067,6,0,6,J,28.95821259385425
64057,2067,2,2,4,E,28.854432746107243
120399,2067,10,2,12,P,29.146977430930185
81666,2067,4,2,6,A,29.28292052754902
96069,2067,5,2,7,D,29.26088993391739
144876,2067,3,2,5,N,29.346011320175407
164804,2067,4,3,7,P,29.23736314047788
72491,2067,6,2,8,E,29.235200537959532
132614,2067,0,4,4,C,29.131786539550475
176902,2068,5,2,7,J,28.768909178633866
139728,2067,9,3,12,N,29.429967037610336
82602,2067,5,1,6,P,29.48380609494697
112388,2068,6,2,8,K,28.950853834213184
104976,2068,3,3,6,P,28.754063993342424
113388,2067,5,0,5,M,28.777066776739623
36518,2067,2,2,4,J,29.05044863599039
115044,2068,4,2,6,K,28.7802314993696
17055,2068,7,3,10,A,28.792704996109805
105704,2067,6,1,7,N,29.374769535628307
111906,2068,3,1,4,N,28.949704558280956
127980,2067,3,1,4,N,29.3676426197108
92127,2068,2,2,4,E,28.989798546938143
144023,2068,3,2,5,N,28.92846167580282
158344,2068,5,1,6,N,28.900737236200253
146708,2067,3,3,6,P,29.09678132863488
65402,2067,4,2,6,E,29.13819629407724
149206,2068,5,1,6,M,28.503106405242534
25742,2068,3,0,3,D,29.086207094347547
48217,2067,4,2,6,S,29.083100778581983
25117,2068,6,1,7,D,28.946156542366573
132755,2067,13,2,15,E,29.11968031431779
35307,2068,7,2,9,H,28.850589398660663
74246,2068,10,0,10,F,28.97988623810527
23633,2067,5,2,7,N,29.397482626142875
142728,2067,7,1,8,D,29.12241075879665
51918,2067,4,2,6,E,29.3101385491449
147107,2067,14,4,18,P,29.256147461892866
63146,2067,3,1,4,K,29.14024249959097
21349,2068,3,1,4,D,28.843291289043524
132889,2067,5,1,6,S,29.29867968414084
177648,2068,5,1,6,M,28.64188350180759
41064,2067,6,1,7,S,29.31564600480099
69328,2068,5,0,5,N,29.02727484776737
98283,2067,5,1,6,N,28.88322124813854
123463,2067,2,3,5,A,29.28442751709997
35857,2068,6,2,8,D,28.77048616802262
130800,2068,3,2,5,J,28.769146568249237
68250,2067,7,2,9,J,28.77100650041641
68826,2068,5,1,6,M,28.801101813024665
78164,2068,2,3,5,A,29.010064517358817
146710,2068,8,2,10,P,28.62240489143571
144127,2068,3,3,6,P,29.138307194193946
121275,2068,5,2,7,K,28.837510562923924
113613,2067,3,2,5,E,29.23393573183947
150595,2068,4,2,6,M,28.823443007881163
156915,2067,2,0,2,N,29.122508794880847
132930,2068,5,0,5,E,28.77571104790487
141528,2068,5,1,6,M,28.70161926443
45815,2067,3,1,4,Q,29.109892794554117
131629,2067,3,2,5,S,29.13186393814976
91602,2067,3,2,5,N,29.27318718385437
124023,2068,3,1,4,M,28.892651772097896
27796,2067,2,3,5,A,28.911824563491017
77845,2067,6,1,7,M,29.08826376205369
31981,2067,4,4,8,F,29.113991380022227
157273,2067,6,2,8,D,29.24987883273528
93208,2067,4,2,6,D,29.091203007990625
175198,2067,6,2,8,J,28.992290128127035
16481,2067,6,0,6,D,29.087486288811583
120908,2068,3,1,4,K,29.135833870819877
129318,2068,6,0,6,K,28.735215224828696
114169,2068,6,2,8,M,28.949330511901056
115238,2068,6,0,6,M,28.63982793163262
27645,2068,2,0,2,Q,28.633927492352992
128568,2068,7,1,8,A,28.843060111984546
89612,2067,5,1,6,C,29.44543845668337
95370,2068,5,0,5,N,28.99887554644906
81728,2068,4,0,4,J,29.09227278827679
78136,2067,6,0,6,P,29.442215940874277
141738,2067,2,3,5,K,29.09559121385773
137291,2067,6,2,8,P,29.246692286832204
102702,2067,5,1,6,J,29.12061133172304
125046,2067,3,2,5,M,29.588571525759505
167009,2068,6,3,9,M,28.817566910926
124895,2068,6,0,6,M,28.768467247944663
41730,2067,4,4,8,N,29.007260812016696
52403,2068,6,0,6,Q,28.878203586483085
61337,2068,3,0,3,J,28.85821922472005
56510,2067,7,1,8,P,29.47479633424189
21095,2067,9,0,9,E,29.232832730231245
47007,2067,5,0,5,Q,29.329143167674403
148723,2067,2,2,4,Q,29.04392871426562
119554,2068,4,0,4,E,29.01693784693104
36646,2068,5,0,5,E,28.775393578501888
149750,2068,2,2,4,M,28.642788305492733
174600,2067,4,3,7,D,29.206705031834733
53108,2067,5,2,7,D,29.178320215079943
167598,2068,7,1,8,M,28.684144170643
112022,2068,16,1,17,H,28.77681785694076
109377,2068,12,7,19,E,28.751500190546164
73864,2068,4,1,5,N,28.8584337381858
52142,2068,6,0,6,K,28.87799506270935
84274,2067,8,3,11,M,29.33208063292216
143919,2067,2,1,3,N,29.201464083190757
104497,2067,5,1,6,K,29.146043769486656
98823,2068,1,2,3,N,28.79760690724164
124478,2068,3,1,4,K,28.819936878684757
98834,2068,3,0,3,Q,28.770917763493447
100156,2067,5,0,5,P,29.19294138590168
27233,2067,4,1,5,D,29.100105615465036
81574,2068,5,0,5,A,28.915000681305266
41188,2067,4,1,5,D,29.22317208015309
56148,2068,5,2,7,M,28.97144049362459
101863,2067,4,0,4,E,28.91457732307921
83308,2068,3,2,5,E,29.17797492053245
50845,2067,1,1,2,E,29.260290774850784
62885,2067,2,2,4,N,29.32452227843864
131791,2067,4,0,4,P,29.281238568031878
71754,2068,3,0,3,N,29.03584595953769
156418,2068,4,1,5,D,28.96664579335001
82796,2068,5,1,6,A,28.78826087596903
45008,2067,4,1,5,Q,28.88044423846249
83631,2068,6,3,9,I,29.12755258369585
112973,2068,5,4,9,J,28.6594832123979
64365,2068,4,1,5,Q,28.990650636821783
98607,2067,3,1,4,J,28.88603038477307
61012,2068,2,2,4,N,28.86413978682977
91880,2068,4,1,5,J,28.89165438447331
60074,2068,3,0,3,J,28.966398125762453
101493,2067,6,3,9,N,29.396455974034318
18476,2067,7,1,8,D,29.51319001364884
106849,2068,2,1,3,K,28.71659462725893
142971,2068,3,3,6,M,28.732874029658756
55295,2067,6,2,8,N,29.293163946513868
67425,2068,17,6,23,E,28.710826650603767
66445,2067,5,1,6,A,29.57999568095069
122288,2067,3,1,4,E,29.10897151493591
56739,2067,5,1,6,M,29.0670058083306
19132,2068,3,0,3,E,28.996435809264423
55635,2068,5,5,10,I,28.879955431136292
94897,2068,4,1,5,J,28.715202778603544
146322,2068,15,4,19,E,29.04039422648588
112841,2068,4,0,4,M,28.869361248053096
69948,2067,3,2,5,E,29.27694819672557
106579,2068,7,4,11,L,28.773732722726628
25043,2067,3,1,4,Q,29.272740569451663
176181,2068,2,2,4,N,28.759636534980103
91555,2068,8,3,11,E,28.85017300343162
171517,2068,2,1,3,D,28.809979994488067
131200,2068,5,2,7,N,28.625757705101417
178741,2067,1,3,4,N,29.11692782127657
147115,2067,5,1,6,S,29.110561353001884
148033,2068,7,1,8,N,28.68574311743549
76600,2068,1,1,2,N,28.68365873987645
90113,2067,7,1,8,M,29.295207003186636
171502,2068,2,3,5,M,28.935370807169612
148642,2068,4,3,7,K,28.845007422995703
36520,2068,5,2,7,C,28.763883964475085
45378,2067,3,2,5,D,29.01686410141329
146390,2068,3,2,5,N,28.793441965885798
94949,2068,5,0,5,J,29.10193705144274
116920,2067,5,1,6,N,29.15283035992152
31544,2068,4,4,8,E,28.94176054986264
133324,2068,3,2,5,K,28.813662976841453
60851,2067,4,2,6,N,28.82198191103886
97124,2068,8,2,10,Q,28.75905385086904
86300,2067,4,0,4,N,29.534412844179
106488,2067,1,2,3,M,29.074442397191625
78353,2068,3,2,5,J,28.85839773553604
42618,2068,4,2,6,K,28.614028564904284
164337,2067,2,1,3,M,29.051344503426243
169257,2067,2,4,6,N,29.09220268758444
176278,2068,5,1,6,Q,28.956849718318576
157647,2067,5,4,9,C,28.98333823370085
172399,2068,14,3,17,D,28.754599046716976
21553,2068,3,0,3,M,28.748541801477817
182541,2068,7,1,8,M,28.804929177162045
161555,2068,3,1,4,E,28.77377150478743
123387,2068,3,3,6,E,28.776530445503266
172860,2068,2,0,2,D,28.795699137121723
148245,2067,6,2,8,M,28.92245748287785
29453,2068,4,2,6,E,28.859955654154582
129917,2067,4,1,5,E,29.125301086634472
46284,2067,4,2,6,E,28.92970836351114
121362,2067,2,3,5,K,29.19362569909136
150461,2068,3,1,4,Q,29.03786930941537
56855,2068,7,1,8,M,28.96094839318982
141278,2068,3,0,3,M,28.82595162488417
141010,2067,1,3,4,M,29.428839683941117
120285,2068,17,4,21,E,29.212309905273514
88709,2068,6,2,8,N,28.82011878550498
103311,2068,6,2,8,N,28.48716963757617
96077,2068,7,2,9,M,28.585362735289102
102407,2067,4,4,8,K,29.30536669178865
117176,2067,7,1,8,E,29.156795656556213
22071,2068,4,1,5,M,28.93919441356681
118978,2068,2,1,3,J,29.07366094399615
111540,2067,4,1,5,E,29.357533120259784
115544,2068,2,1,3,M,28.788998182190497
33130,2068,6,1,7,K,29.011455317133503
126904,2068,2,1,3,E,28.669136042080776
147013,2067,6,2,8,M,29.23018005593676
141760,2068,2,3,5,E,28.891002131402303
67936,2068,6,2,8,P,28.771214262806847
133894,2067,3,1,4,J,28.987707276380235
129010,2067,3,0,3,P,29.333314698400567
145711,2068,5,2,7,M,28.702794128162004
55371,2068,4,2,6,J,28.737593763667228
97715,2068,2,0,2,A,28.66937347347884
100579,2067,4,3,7,K,28.99553427206035
100041,2067,7,1,8,E,28.973124389083598
146310,2068,6,1,7,E,28.79962110566798
71546,2067,2,0,2,M,29.2818446298168
95538,2068,2,0,2,Q,28.94763156460199
49644,2068,2,1,3,J,29.25922316669357
24394,2068,7,1,8,D,28.715223181239782
16578,2068,2,1,3,N,28.53915082996279
24602,2068,1,3,4,D,28.5960998347008
90020,2067,4,0,4,H,29.12601564031623
146927,2067,3,0,3,P,29.304218926741576
111675,2068,5,1,6,M,29.122828749929937
157786,2067,2,2,4,Q,29.22547131041094
156550,2068,4,2,6,D,28.99713646582587
17279,2068,2,2,4,K,28.80876894895232
118257,2067,3,2,5,H,28.99719157332202
62678,2068,6,1,7,P,28.91675029673
111831,2068,3,1,4,J,28.59881257668072
92380,2068,7,1,8,Q,28.75982413707905
151181,2068,6,1,7,C,28.986742500064626
105154,2068,5,0,5,N,28.64633391350227
82442,2067,7,2,9,J,29.201505495393885
167229,2067,3,2,5,J,28.971507229089628
18687,2068,2,4,6,E,28.930595046759883
114751,2068,4,0,4,E,28.792846838045826
145437,2067,2,1,3,J,29.09954464760556
111519,2067,5,2,7,J,29.299563257317672
67433,2067,10,1,11,M,29.18422657934508
81583,2067,2,2,4,E,29.023857521542265
142091,2067,6,1,7,S,29.320103064106178
64535,2068,6,1,7,J,28.76795729293465
164399,2067,4,3,7,E,29.228821603758167
121847,2068,3,0,3,K,28.812847293078725
148917,2068,7,2,9,P,28.43628846592895
172266,2068,5,2,7,P,28.98948634561859
129045,2068,7,2,9,E,29.021298509971327
115558,2068,2,2,4,N,28.92780662132721
135634,2067,4,0,4,P,29.04157290833856
128662,2067,1,4,5,C,29.386704699613077
58646,2067,8,0,8,D,28.894911470781253
85931,2067,1,2,3,S,29.22469480616801
137038,2068,3,3,6,E,29.065510696148127
127580,2068,6,2,8,E,28.556643566725267
16686,2067,4,2,6,E,29.362563292745428
174257,2067,3,3,6,J,29.235207221757427
90104,2068,2,2,4,I,28.801529424124297
134167,2068,7,2,9,E,28.928840154731056
16993,2067,3,0,3,P,29.04904514554502
148754,2068,6,2,8,M,28.96288211459204
92846,2068,8,0,8,D,28.69664847356275
26234,2067,3,2,5,J,29.31233867458165
90958,2068,6,2,8,M,28.926767339534567
130809,2067,4,1,5,M,28.974097894851887
64827,2068,2,2,4,E,28.93772155691568
74852,2068,4,0,4,M,28.969418891506862
86386,2068,3,1,4,Q,28.443597282461575
126445,2068,7,1,8,J,28.856263165773782
102305,2067,3,1,4,M,29.21114473114072
49841,2068,4,3,7,F,28.97780503872184
179039,2068,7,2,9,P,28.821178047994277
158591,2067,6,1,7,M,28.94483729910625
37428,2068,5,0,5,E,28.897859484114807
20816,2068,4,3,7,N,29.04733795379521
41593,2068,7,2,9,M,29.173673880521488
131200,2067,5,2,7,N,29.047441174213837
18331,2068,5,0,5,D,29.270664902892413
39735,2068,3,0,3,D,28.80035512441229
101548,2067,9,1,10,Q,29.090312140497343
103692,2068,7,2,9,N,28.952003078419203
55965,2068,6,2,8,C,28.51106593182695
54029,2067,5,1,6,N,28.80839452254168
71746,2067,6,1,7,Q,29.304219705211903
145785,2067,4,1,5,Q,29.425740944327604
55795,2067,4,2,6,Q,29.37544297278832
41568,2067,5,1,6,Q,29.006483518300808
67412,2067,2,2,4,E,29.20400295063676
117463,2068,11,2,13,I,29.207650043976464
34133,2067,6,1,7,D,29.26710285569356
40472,2067,4,2,6,K,29.043048450258038
138913,2067,5,3,8,M,29.07350622483167
146964,2067,4,2,6,M,29.35152710923146
36043,2067,6,1,7,N,29.091661236100755
54692,2068,7,2,9,Q,28.89740222616291
156882,2068,6,3,9,J,29.04453199544161
119731,2067,2,1,3,E,29.52628711299088
31634,2068,6,1,7,G,29.0429755075781
122612,2068,5,2,7,M,28.64123640524685
147107,2068,12,2,14,P,29.209016657470794
74455,2067,5,1,6,J,29.06757960704152
168298,2068,6,1,7,M,28.87887305084581
137263,2067,2,1,3,M,28.970112040637563
32561,2068,7,4,11,C,28.58318793159775
82796,2067,3,2,5,A,29.22272319202515
171915,2068,6,0,6,J,29.02729040271825
172875,2067,2,2,4,Q,29.266606055839343
99006,2067,4,2,6,E,29.38302491354375
85057,2067,6,0,6,I,29.0490364670237
71493,2067,5,1,6,M,29.21529891553373
89660,2067,2,1,3,E,29.068077147198952
120465,2068,4,1,5,K,28.9992401762483
69717,2067,4,1,5,K,29.1758758871684
84178,2067,2,0,2,E,29.2981722435658
142323,2067,5,4,9,M,29.385681867018125
22650,2067,3,2,5,N,29.34285586463215
67202,2068,4,3,7,D,28.75048629900633
129398,2068,5,0,5,J,28.91246052242085
105317,2067,2,2,4,M,29.07356239377456
121562,2068,2,3,5,E,28.874907585476983
88006,2067,2,1,3,P,29.323718038685517
135868,2067,4,2,6,Q,29.249099764018364
144273,2068,4,2,6,P,29.20678984058062
119835,2068,6,1,7,E,28.6749440213728
133849,2068,8,1,9,P,28.874907993637517
147691,2068,2,4,6,M,29.260958627796484
162677,2067,1,4,5,N,29.16414675498232
93860,2067,5,1,6,A,29.62083941597037
31004,2068,3,0,3,E,28.969088689490103
130632,2068,1,1,2,M,28.692322837161043
76491,2067,2,2,4,I,29.585513121438016
98212,2067,7,2,9,N,29.215198759853426
173921,2067,4,0,4,E,28.996447526055636
117666,2068,7,1,8,Q,28.990336533292272
128264,2067,4,2,6,N,28.97567858432865
133559,2067,5,1,6,N,29.00574787766284
113910,2068,2,4,6,E,28.62449323472668
111415,2068,4,0,4,J,28.632185548956205
92610,2068,5,1,6,J,28.987660255074843
111211,2067,2,1,3,S,29.190984884337933
56304,2067,3,2,5,E,29.21750688181583
45070,2067,6,0,6,D,29.391816722668167
148662,2068,4,0,4,M,28.93913571023347
105965,2068,3,2,5,J,29.06169858479998
135844,2067,3,0,3,M,29.287095416052072
38719,2067,4,2,6,K,29.16394520168507
181452,2068,7,0,7,P,28.720696669658427
21802,2067,5,1,6,M,29.362275932388936
149205,2068,2,2,4,A,28.894296035576392
121096,2068,7,0,7,D,28.86952288706854
130470,2068,7,1,8,J,28.895084010667148
67751,2068,5,2,7,E,28.986225274545248
20849,2068,8,2,10,P,28.806044933664857
17818,2068,4,1,5,N,29.01170866275612
71097,2067,5,0,5,K,29.718640841460584
95747,2067,8,3,11,I,29.119882157302417
46214,2068,4,1,5,S,28.70621526262667
97296,2067,4,1,5,N,28.99223506147633
169746,2068,5,1,6,Q,29.272574845225428
160588,2067,5,1,6,N,29.07713663080723
31474,2067,3,1,4,E,29.13713776314073
118543,2067,4,2,6,D,28.88872396439448
135756,2067,2,1,3,M,29.13245784999773
117867,2067,6,0,6,K,29.235147451012686
94730,2068,5,1,6,M,28.855264429182863
77826,2068,6,2,8,S,28.938853875579465
127218,2067,3,2,5,N,29.187567170530453
46072,2067,8,2,10,K,29.07521017245361
123323,2067,5,3,8,K,29.32559092188543
46752,2068,6,0,6,N,28.7520092420412
133029,2067,2,0,2,E,29.36787688747816
170208,2068,6,1,7,P,28.845258349618923
109690,2067,3,1,4,N,29.267850732079825
16299,2068,6,2,8,P,28.855302298279327
50641,2067,2,2,4,N,28.970096660595814
136562,2068,4,3,7,K,28.512098802431293
120089,2067,11,4,15,E,29.25946892845941
28981,2067,4,1,5,M,29.43347450665573
115831,2067,7,2,9,I,29.19122557503706
114106,2067,4,0,4,K,29.44854262099488
18873,2068,2,1,3,S,28.87508319077567
138474,2067,6,0,6,D,29.126144486949645
48984,2067,6,1,7,C,29.0533504730327
55842,2067,5,4,9,N,29.195442721790418
94340,2067,7,5,12,N,29.44465836401097
122056,2067,2,3,5,P,29.167075630019784
73051,2068,8,2,10,N,29.118476823422256
125369,2067,4,0,4,E,29.209146456449112
56777,2067,4,1,5,N,29.02853757668133
26909,2068,3,0,3,Q,28.908692844547463
41309,2067,4,3,7,N,29.16566263808528
125185,2067,3,0,3,A,29.278842113332377
50122,2068,4,1,5,M,29.03394984342009
169665,2068,5,3,8,Q,28.74032085547341
118616,2068,4,2,6,D,28.873603378796695
158198,2067,6,2,8,P,28.92150205686767
55929,2068,8,0,8,Q,28.753796386891445
52678,2067,5,2,7,M,29.107536180295853
143440,2068,2,2,4,N,28.827463713484303
127343,2067,4,0,4,N,29.233123813678
22439,2068,3,0,3,J,28.56587078507224
64721,2067,2,0,2,E,29.2647870095524
75457,2068,4,0,4,N,28.705884669377877
159448,2067,7,2,9,D,29.276967602501607
41350,2068,4,1,5,J,29.10420635981973
47462,2068,2,4,6,S,28.68188772263749
30641,2068,5,1,6,E,28.6811635526626
112505,2067,5,1,6,M,28.980531542901456
60071,2067,2,1,3,N,29.197462879577028
110378,2067,8,0,8,D,29.320714850909
182847,2068,5,0,5,M,28.638959809238717
141740,2068,5,0,5,P,29.139604318062958
118315,2067,2,2,4,E,29.63309524913987
51832,2067,3,1,4,Q,29.26790240287944
59149,2068,5,3,8,N,28.81476434649514
38645,2067,3,2,5,E,28.91779650535358
141441,2068,5,1,6,P,28.968523940784053
135700,2067,5,1,6,J,29.08639121795577
124468,2067,4,0,4,K,29.267842625860915
58649,2067,9,1,10,Q,29.402159861232796
69490,2067,3,0,3,N,28.994089264349974
165258,2067,7,0,7,M,29.160956535222468
160825,2068,7,0,7,N,28.723847244466576
92578,2067,4,3,7,Q,29.252259386799587
77907,2068,3,1,4,E,28.621754825132548
25169,2068,4,0,4,N,28.83564866769844
76859,2068,3,1,4,J,28.95419254283509
167231,2067,5,2,7,M,28.726457191635244
141139,2068,3,2,5,E,28.72698278283887
107937,2068,2,1,3,E,28.954811031889932
167291,2068,4,1,5,Q,28.93303781195305
177107,2068,2,1,3,N,28.999907051730244
169975,2067,17,0,17,D,29.214654500624956
115556,2068,4,2,6,E,29.01730159809303
30799,2068,7,0,7,P,28.850586012793084
96913,2068,5,2,7,J,28.79838875363404
41020,2068,3,0,3,J,28.758253281340785
124439,2068,6,0,6,J,28.91178790218112
185031,2068,13,4,17,P,29.0616535744867
166934,2068,6,0,6,D,28.92177700266165
103733,2068,5,2,7,S,29.105053929089603
77058,2067,6,0,6,P,29.48717587155111
65323,2067,4,0,4,N,29.16976560285225
148002,2068,2,2,4,A,28.662344305130173
44301,2068,10,2,12,A,28.845286486618143
125586,2068,7,1,8,P,28.59736095230148
166382,2067,1,2,3,M,29.38678797318609
66871,2067,3,2,5,N,29.12885358669468
159266,2068,6,2,8,E,28.791707144477957
179317,2067,6,2,8,D,29.030758333200662
133421,2068,2,2,4,J,28.826000574300533
57519,2068,6,2,8,M,28.904648230205943
107532,2067,3,1,4,K,29.49079994384361
29479,2067,7,1,8,N,29.11794315511885
110419,2068,5,1,6,N,28.47882828495083
76629,2068,14,10,24,I,28.86070986662709
20853,2068,3,0,3,J,29.00830070195893
50955,2067,5,2,7,I,29.33840070425921
55948,2068,2,2,4,P,28.93293765509814
137196,2067,5,1,6,M,29.15920192740039
141754,2068,3,1,4,M,29.1207410046686
120663,2068,8,2,10,P,28.776614254030317
167601,2068,3,0,3,Q,29.0372314554284
17305,2068,2,2,4,E,28.82893006144191
181817,2068,5,3,8,N,29.218619117047368
164409,2068,3,0,3,N,28.904919329814216
36739,2068,4,3,7,E,28.627506651081276
73710,2068,7,2,9,J,28.883668150323192
19100,2067,3,3,6,K,28.99098962069567
103239,2067,4,1,5,A,28.974434331559745
163545,2068,6,1,7,I,28.8574618206096
106269,2067,6,1,7,M,29.054575300048025
143589,2067,1,2,3,P,29.613216403905675
31350,2068,6,1,7,Q,28.66485356818081
73676,2068,4,2,6,Q,28.8547204037043
96941,2068,16,2,18,A,29.100712961348467
170425,2068,7,2,9,D,28.63868250718673
129387,2068,5,1,6,E,28.79771578985654
167359,2068,7,0,7,Q,28.965798629827184
73428,2068,2,3,5,N,28.740205636060857
141544,2068,5,1,6,S,28.736485686565526
139496,2068,5,2,7,M,28.419088656141813
97325,2067,4,2,6,N,29.077643447979117
47042,2067,5,1,6,Q,29.15987767988945
159499,2068,8,2,10,J,28.821680501505128
64927,2067,5,0,5,D,29.100743555062262
18719,2068,2,2,4,N,29.15724533329979
56932,2067,5,0,5,M,28.953912349984584
94181,2068,2,1,3,Q,28.70960157261053
145812,2067,6,1,7,A,29.217188128616204
27058,2068,11,1,12,D,28.95893959211833
24341,2067,5,2,7,D,29.2448773815298
95634,2067,2,2,4,S,29.455578345495645
164506,2068,3,2,5,S,29.346874970646034
111120,2067,4,1,5,K,29.261828038084804
114886,2067,4,1,5,M,29.43125305177154
180713,2068,5,2,7,E,28.94724527466686
137789,2067,4,0,4,D,29.01412351533268
167231,2068,4,2,6,M,28.534513841846884
87879,2067,2,2,4,Q,29.253345061645483
27452,2067,4,2,6,D,28.891167431445503
167944,2068,5,3,8,A,28.88514002778403
170473,2067,3,0,3,Q,29.216206957149986
173288,2068,10,1,11,L,28.796453064112345
105418,2068,10,3,13,E,28.78732942317886
99755,2068,5,2,7,K,28.86125778751195
74012,2067,5,2,7,E,29.52711791734212
169916,2068,7,0,7,J,28.75186218921545
151187,2068,5,0,5,E,28.72902859010541
98565,2068,7,0,7,E,29.05895399042536
75464,2067,5,1,6,N,29.635236913510237
39052,2067,6,1,7,Q,28.984369782649665
74804,2068,3,0,3,L,28.715504223902105
98829,2068,4,0,4,I,28.66044626166664
128162,2067,3,2,5,E,29.62127201393213
49817,2068,9,2,11,J,28.932003771341137
24099,2068,7,0,7,D,29.189884242517625
115183,2068,3,2,5,M,28.68732445014472
47209,2068,2,0,2,E,28.61234737825913
25424,2067,2,1,3,E,28.919507639366916
130678,2068,4,2,6,N,29.283290944741463
162989,2068,6,2,8,N,28.81462540592313
136940,2068,7,1,8,L,28.900480933127454
100675,2067,3,2,5,K,28.99216842968096
132020,2067,4,2,6,E,29.127281665311813
28158,2068,3,1,4,D,28.911944923394376
118324,2068,7,0,7,H,28.88021069380512
143741,2067,2,0,2,Q,29.328568353661264
55846,2068,9,2,11,Q,29.13010047493746
157607,2068,6,0,6,D,29.28387150480565
102392,2068,3,0,3,D,28.600142072469485
181420,2068,3,3,6,N,29.19408715818118
144396,2068,6,2,8,K,29.07910648559658
120720,2068,6,0,6,N,29.0165951353699
145954,2068,5,2,7,P,28.63864904726216
71751,2067,5,3,8,E,29.09334532636153
142333,2067,5,3,8,Q,29.444171123222752
45268,2067,6,1,7,E,29.189638961062983
150267,2068,6,2,8,M,28.826967618181627
157316,2068,3,0,3,N,29.19121841217503
129532,2068,4,0,4,E,29.325383154497505
178482,2068,9,2,11,D,28.97968036225257
129674,2068,4,2,6,N,28.701844599241745
136212,2067,3,1,4,M,29.21371698532038
24640,2068,3,3,6,Q,28.61988909017096
77424,2068,5,0,5,A,28.56689183168669
74148,2067,2,0,2,H,28.96591109757278
181914,2067,8,0,8,A,29.12146650249175
149141,2068,10,3,13,N,29.00716284849937
92531,2068,7,1,8,E,28.607736880060887
65070,2067,0,4,4,D,29.01639819412881
69865,2067,4,2,6,D,29.377686231255527
124904,2067,3,1,4,R,29.11099534548577
53765,2068,4,5,9,M,28.907836319903964
18867,2067,4,2,6,Q,29.226581066562705
166261,2068,1,2,3,C,28.99738352792664
133875,2068,5,0,5,H,28.7252795102992
46538,2067,4,2,6,N,29.123351576848247
24028,2067,4,3,7,J,29.126069239770278
141219,2067,17,3,20,E,29.318360035470743
76074,2067,7,0,7,E,29.102816179013136
73229,2068,5,2,7,M,28.971913608479937
40715,2067,2,0,2,J,29.403161483062892
166446,2067,6,0,6,P,29.033336063122626
22040,2068,7,2,9,Q,28.597635913504984
30761,2068,9,6,15,F,28.72736363155422
161958,2068,5,1,6,P,29.00269354436506
50449,2068,3,2,5,E,28.847892615449624
32738,2067,5,2,7,E,29.35923227610845
113505,2067,1,2,3,E,29.16072473399939
20627,2067,3,2,5,J,29.12270552584568
61902,2067,6,1,7,K,29.28213121357993
127239,2067,1,2,3,P,29.20237454523976
172062,2067,4,2,6,D,29.305809993836306
21390,2068,6,2,8,K,29.158671571376686
178739,2068,5,1,6,N,28.7100343382248
164188,2067,7,2,9,M,28.988355829913225
145185,2068,2,3,5,D,28.742880047005592
141170,2068,3,1,4,Q,28.78508553718221
145437,2068,5,0,5,J,29.08700103913358
78703,2068,6,2,8,S,28.845829575548223
137389,2067,2,2,4,H,29.056155637074205
64080,2068,4,2,6,P,28.82506831860476
139958,2068,5,2,7,P,29.20726711619012
145221,2067,8,1,9,F,29.201437079411058
131245,2067,2,2,4,N,29.530759861573355
46138,2068,3,0,3,N,28.92557415091669
58949,2067,14,4,18,M,28.86834823393953
160617,2067,2,1,3,P,29.22179879491932
61421,2068,9,4,13,D,29.13064333532255
63165,2068,6,2,8,J,28.992782321289297
148691,2067,3,2,5,M,29.39506781912883
21803,2068,7,2,9,F,28.883307570361428
146281,2068,3,1,4,M,29.066260132137327
20746,2067,7,2,9,M,29.6355004493868
144005,2068,4,1,5,C,28.75681669168262
58950,2068,7,0,7,D,28.718028604781267
109246,2067,6,3,9,A,29.24617058146838
171072,2068,4,1,5,K,28.733132932549843
83484,2068,5,1,6,M,28.8146334130723
16702,2068,2,1,3,D,28.77676549528328
173223,2068,6,1,7,H,28.87376222900924
37075,2068,6,2,8,E,28.67721240144174
72371,2067,6,1,7,S,29.315135656328845
71640,2068,3,2,5,E,28.89374310827857
92259,2068,4,2,6,F,29.01734235756677
164669,2067,5,1,6,I,29.10564958197709
137174,2068,3,1,4,K,29.469032334624966
164862,2068,6,1,7,D,29.08201158504145
161455,2068,6,1,7,K,29.127133392058465
46188,2067,12,2,14,Q,29.27675295694369
163086,2067,3,1,4,S,29.026561350080108
128118,2068,2,2,4,N,29.271189886269045
131525,2068,7,1,8,E,28.921468220057186
90316,2068,4,0,4,H,29.106346578100016
82831,2067,1,2,3,J,29.141465728448694
15957,2067,7,1,8,D,29.207160738104623
115502,2068,6,2,8,N,28.791520816976423
100535,2067,1,3,4,N,29.132383459270837
156094,2067,2,2,4,J,29.151259084115903
17258,2067,6,3,9,N,29.0956837667357
97951,2068,6,2,8,H,28.87764375661057
130909,2067,6,0,6,E,29.32176340462586
41430,2067,4,2,6,S,29.21992369792896
92031,2067,4,2,6,K,29.454485204605422
83629,2067,2,2,4,E,28.918085110739664
62332,2068,1,2,3,E,28.820392405556834
29862,2067,6,0,6,H,29.103328602052883
163302,2068,4,1,5,P,28.723008377886583
164770,2068,3,3,6,M,29.22071115175126
19478,2067,5,1,6,E,29.12818192451565
21201,2067,2,3,5,S,29.005931105293698
31072,2068,4,2,6,D,29.08395550723847
170774,2067,2,3,5,E,29.57503372090893
68826,2067,3,2,5,M,29.146425064552908
58712,2067,4,1,5,S,28.953427309608564
128220,2068,7,2,9,K,28.70161935238276
102662,2067,5,2,7,Q,29.150524100529605
105925,2067,3,4,7,J,28.894941719791493
103623,2067,7,1,8,E,29.177060283438703
25336,2068,14,0,14,J,28.75344298748544
114559,2068,2,3,5,J,28.80972703266526
20058,2067,4,1,5,E,29.01015846618355
22466,2067,7,1,8,Q,29.147393757627952
52415,2067,2,2,4,M,29.23848914605588
147613,2067,6,2,8,P,29.070849138320927
133879,2067,1,2,3,K,29.613014132857625
114702,2067,4,0,4,N,29.15921121615948
133976,2068,4,1,5,P,28.77285131820429
30211,2068,6,2,8,P,29.046499296144468
146881,2067,8,2,10,F,29.11970708228113
119620,2068,2,2,4,S,28.68884277652616
45751,2068,2,1,3,E,28.902632106088763
158216,2068,2,3,5,N,28.91602520083026
159803,2068,4,3,7,E,28.88897377647752
97733,2068,4,1,5,E,28.97209793158489
158533,2067,13,2,15,R,29.01095994079164
54966,2067,4,1,5,A,29.08978115739655
44308,2067,4,0,4,P,29.338340406919425
21097,2067,2,0,2,N,28.980216439545234
86992,2068,3,3,6,P,28.820698813100304
76854,2068,7,1,8,Q,29.11125594082554
106843,2068,1,3,4,J,28.842959598900716
117828,2067,6,0,6,M,29.241753293540405
101482,2068,10,1,11,L,28.84059417122336
129177,2067,4,2,6,H,28.854820603365845
49820,2067,9,2,11,E,29.198311810836373
53963,2067,3,1,4,N,29.161521278395107
116023,2067,4,2,6,Q,29.19287323550776
127704,2068,5,0,5,K,28.865142081559192
77093,2068,2,2,4,E,28.69603680911039
118753,2067,4,2,6,J,29.37702584768206
124300,2067,5,2,7,M,29.434607144243227
25630,2068,2,1,3,E,28.84874404962695
78883,2068,7,2,9,I,28.84269377736742
111944,2067,6,0,6,E,29.22206822917977
54511,2067,4,1,5,P,29.11955638665845
58851,2067,6,2,8,E,29.222383529097872
92549,2068,6,2,8,P,28.78201283970941
132255,2068,5,0,5,P,28.97211095699535
141389,2067,7,2,9,E,29.26258074164021
138474,2068,7,2,9,D,29.302434608611943
64661,2068,2,0,2,N,28.819919443675573
114036,2067,3,2,5,D,29.420712574894026
128406,2068,4,2,6,S,28.906220515888585
133217,2067,5,3,8,N,29.25226508745489
116379,2067,4,2,6,N,29.30132000026887
146297,2067,5,3,8,M,28.784399623025564
76269,2068,3,2,5,A,28.78903547300412
127083,2067,2,2,4,S,29.1756348170055
164694,2068,1,2,3,E,28.778595731177635
76756,2068,8,1,9,M,28.77517676754386
87577,2068,3,1,4,F,28.63447514515144
133620,2068,6,1,7,J,28.74779996296461
131007,2067,8,2,10,M,29.21653870810608
179360,2068,4,1,5,P,28.46806993943604
118545,2068,2,1,3,K,28.72561948991321
66750,2068,9,2,11,Q,28.88110690388987
20789,2067,10,2,12,E,29.299817901619686
163508,2067,2,2,4,E,29.06691640458836
138479,2067,5,1,6,A,29.039777795302744
120377,2067,3,5,8,E,29.271885184982725
93677,2067,2,1,3,J,29.15319646859217
181453,2068,5,3,8,Q,28.92831375901748
101488,2068,13,3,16,E,28.824410008210208
179360,2067,6,1,7,P,29.379871086091292
63164,2067,2,0,2,R,29.416879234302016
98383,2068,6,0,6,N,29.084296607941507
40825,2068,6,0,6,N,28.7409776413098
119777,2067,7,2,9,K,29.040617469411224
66809,2068,2,0,2,Q,28.861330805480605
76767,2068,4,0,4,M,28.868285972321434
150530,2068,5,1,6,M,29.05241975675355
41536,2068,3,0,3,N,28.760148414138225
164429,2068,4,1,5,K,28.972984297776367
167006,2067,6,1,7,Q,29.558143917539
60849,2068,7,1,8,J,28.848537031760458
137779,2067,4,2,6,J,29.165825719802395
29651,2068,3,4,7,I,28.812779463192257
175760,2067,4,0,4,E,29.102527303112083
162730,2068,7,2,9,K,28.43433081426869
137098,2068,9,2,11,E,29.043504624215597
136903,2067,2,0,2,M,29.10346822492486
48387,2068,6,1,7,J,28.903604652558915
25556,2068,2,3,5,D,28.557901137876065
92993,2068,5,1,6,E,29.267990658574416
120152,2068,4,2,6,Q,28.83320605730932
42212,2068,5,1,6,J,28.61257401137406
57345,2068,3,0,3,M,28.987560238393343
124527,2067,4,3,7,E,29.077629555204226
105907,2068,2,2,4,P,29.22974498929913
23473,2067,5,3,8,J,29.07079217431852
108397,2067,4,1,5,E,29.068427585292085
32774,2067,5,2,7,E,29.007616182737685
56224,2068,5,1,6,N,28.97964900057095
102118,2067,3,2,5,E,29.746391682091083
86192,2067,6,2,8,J,29.295843655787777
105031,2068,2,4,6,E,28.932786448100035
157680,2068,5,3,8,A,28.69302233134392
31989,2067,9,3,12,F,29.339978040593177
53709,2068,5,1,6,M,29.069720203311167
123643,2067,4,0,4,P,29.15710626798711
125746,2068,1,2,3,N,28.871573087436676
21039,2068,3,0,3,J,28.896376993366896
157256,2068,6,2,8,C,28.81094862156887
169801,2068,9,1,10,D,28.618807597569297
160597,2068,8,2,10,N,28.681619993525945
141107,2067,6,1,7,Q,29.365632374433204
131784,2068,6,6,12,A,28.91019178919689
47899,2067,3,0,3,N,29.45594721748384
132059,2067,7,3,10,E,29.177939583756025
97135,2067,5,2,7,N,29.426805163177804
52577,2067,6,0,6,P,29.11894386938887
63954,2067,7,2,9,E,29.299205629565595
167081,2068,11,4,15,E,28.986908875885703
70501,2067,4,2,6,N,29.495631671669532
105215,2067,6,1,7,J,29.008399900958132
25749,2068,3,0,3,N,28.729180070187525
47025,2068,6,2,8,N,29.01676353741319
33720,2068,3,1,4,J,28.90298918618977
111241,2067,1,2,3,K,29.277120518800405
131067,2068,2,0,2,E,28.809335289843496
95821,2067,1,4,5,E,29.202214699502687
21232,2067,6,0,6,P,29.198431880625225
89906,2068,5,3,8,M,29.080166102502883
159397,2068,6,0,6,K,28.77783043183621
106885,2068,6,0,6,D,28.99716445094337
131923,2067,6,1,7,D,29.373001294010244
41550,2067,5,1,6,M,28.93276486580284
22423,2067,5,1,6,C,29.11779860616312
177054,2067,5,1,6,D,28.806634098610505
123283,2067,5,2,7,J,29.258951449798055
73731,2067,3,4,7,K,29.318316741751488
30325,2067,2,2,4,K,28.975900680314663
93648,2068,7,2,9,D,28.76771052307491
98454,2068,3,3,6,E,28.726026946708
165286,2068,6,2,8,A,29.07117991950933
100611,2067,2,2,4,Q,29.13464073715425
24945,2068,6,1,7,J,28.81488534398324
113029,2067,6,0,6,K,29.213119340947863
52413,2068,1,3,4,P,28.831997976715712
171389,2067,2,2,4,N,29.04222688582448
145111,2068,3,2,5,M,28.920170747944805
116920,2068,3,0,3,N,28.990814160299266
76369,2068,4,2,6,N,28.74851574467513
92869,2067,3,2,5,N,29.103440824234244
77071,2068,2,3,5,M,29.05933817712599
77575,2067,3,1,4,E,29.026388588156006
107122,2067,3,1,4,J,29.292252167390608
165989,2068,4,3,7,I,28.43782460732477
60040,2067,8,2,10,Q,29.029667955565305
134331,2067,3,2,5,E,29.0925854884725
25488,2068,5,0,5,E,29.0381987317053
109306,2067,5,0,5,I,29.27661157428662
84256,2067,3,2,5,E,29.121262242815085
59361,2068,1,3,4,P,29.00439649697621
129927,2068,4,2,6,E,29.07955246481165
64390,2068,2,0,2,J,28.829507084824694
64088,2067,9,3,12,F,29.40476696982885
159790,2067,3,2,5,N,29.106004376561383
39538,2067,2,2,4,Q,29.04326133148125
48463,2068,1,2,3,S,28.8823626690403
18625,2068,5,2,7,E,28.714618628666827
146087,2067,4,3,7,M,29.226872679341778
169857,2068,3,3,6,Q,28.719413807622107
17609,2067,4,2,6,F,29.41615841992417
116147,2067,4,0,4,E,29.18703058046652
60372,2068,8,1,9,D,28.669478437631525
33901,2068,1,1,2,M,28.84443943369788
131617,2067,6,2,8,M,29.22625790599198
88093,2068,2,0,2,N,28.863164469473496
134806,2067,6,3,9,N,29.07119367316904
109394,2068,3,1,4,E,28.55124601445069
76787,2067,4,0,4,E,29.134923162774665
70798,2068,3,1,4,E,28.859318048114915
164116,2067,7,0,7,E,29.38631892727415
158105,2067,2,2,4,E,28.928843372125137
169905,2068,1,2,3,N,28.805085055169037
66270,2067,8,2,10,Q,29.028338285212683
129418,2068,6,3,9,F,28.72826533891727
24769,2067,2,2,4,D,29.157435338183078
125621,2067,5,0,5,K,28.981952787557155
26568,2068,10,4,14,P,28.946397599293395
51065,2067,2,0,2,E,29.21342935711624
22174,2067,1,2,3,S,29.302622441312533
157227,2068,5,2,7,P,28.694579693190835
125073,2068,5,2,7,K,28.99822876827608
164885,2068,3,2,5,P,28.56475008586616
104531,2067,3,2,5,E,29.500367303268003
40529,2068,4,2,6,D,29.07868285482014
45804,2068,5,1,6,I,28.99920927445497
143679,2068,6,1,7,K,28.889132414967385
113941,2068,6,2,8,E,28.79719754448673
92811,2068,6,2,8,D,28.73088363136114
125564,2067,8,1,9,J,29.05362250979292
36780,2067,5,1,6,D,29.151372500815175
86972,2068,4,1,5,S,28.997394355918345
72630,2068,5,2,7,K,29.186530110013567
25880,2067,3,1,4,E,29.37139159736406
159418,2068,6,2,8,J,29.12636165630685
18983,2068,3,2,5,D,28.81019596357859
144070,2067,6,1,7,S,29.279169149541826
19083,2068,3,0,3,K,28.713760888052352
113913,2068,2,1,3,J,28.98633949314189
106947,2068,6,2,8,K,29.19958017596028
53551,2068,4,2,6,Q,28.756132240460182
182362,2067,4,2,6,Q,29.766574783364
174272,2067,6,2,8,E,29.38138161914415
176479,2067,6,2,8,N,29.24890194514984
136973,2068,2,3,5,E,28.632854128575847
160974,2067,1,5,6,N,29.09787329066507
125117,2067,4,0,4,P,29.40151538951241
16951,2068,15,1,16,D,28.8558996374028
76920,2067,2,2,4,N,29.24930975416712
173080,2068,1,2,3,J,29.00469102145836
97542,2067,12,4,16,J,28.84410979887533
33628,2068,15,2,17,J,29.23463283631103
92989,2068,10,2,12,N,28.93898722469777
96774,2068,4,2,6,M,28.853346099273736
20124,2067,3,0,3,E,29.07174515543469
109532,2067,1,3,4,E,29.224782188044347
148492,2067,5,1,6,M,29.15503324717038
84240,2067,1,1,2,Q,28.98593355387582
145884,2068,4,4,8,F,28.87554295706794
156955,2068,2,0,2,N,28.838017239925467
15837,2068,3,5,8,J,28.661750516394694
145782,2068,4,2,6,Q,28.511369288955564
90256,2068,3,1,4,J,28.580523696058908
104283,2068,10,1,11,I,28.78207448823393
100277,2067,4,0,4,J,28.951274974297306
100750,2068,6,1,7,A,28.848370989476297
130328,2068,5,0,5,K,29.02927988476304
30578,2067,3,3,6,K,29.406779865750075
169259,2068,3,3,6,A,28.96258674043072
49792,2068,2,2,4,D,28.617088421175342
144834,2067,3,1,4,M,29.341995219500344
148296,2068,2,1,3,E,28.702861259944072
59242,2067,4,1,5,P,29.22628094202788
34910,2068,9,4,13,E,28.931811805156755
94312,2067,3,0,3,J,29.242998947343366
127498,2067,6,1,7,E,29.396464198292
28957,2068,5,2,7,E,29.17037004255236
181268,2068,4,2,6,N,28.585113952497988
87888,2067,3,0,3,D,28.99095979622032
146275,2068,6,2,8,P,28.67252288659248
29183,2067,2,4,6,M,28.950244626504517
53993,2068,4,3,7,M,28.78706507001751
96984,2068,10,4,14,F,28.490712818255147
165837,2068,3,0,3,Q,28.930468239211063
180453,2067,4,2,6,E,29.195283898498776
24840,2068,5,3,8,D,28.815964635986187
40951,2067,2,3,5,D,29.569315535375885
65655,2068,3,1,4,J,28.686265876906
78339,2067,3,2,5,N,29.372573330145364
67794,2067,4,2,6,P,29.33004367000037
133693,2067,4,0,4,N,29.109319676552083
91848,2068,2,2,4,J,28.893749111136447
122042,2068,4,0,4,Q,29.07541833528156
27052,2067,5,1,6,E,29.24396529153337
91956,2067,3,3,6,M,29.03198175625674
115483,2067,4,0,4,E,29.22745482373335
16005,2067,2,2,4,A,29.34644728626325
114974,2068,2,2,4,Q,29.00336754071809
166936,2067,9,2,11,Q,29.003891517782076
48862,2068,5,1,6,S,28.59287002180537
123100,2068,3,2,5,E,28.697376919293173
78107,2067,6,0,6,J,29.269620335216157
133848,2067,9,0,9,E,29.252188060360037
66845,2068,4,1,5,E,28.795784444694068
28363,2068,4,2,6,E,28.877911446816533
159916,2067,3,1,4,C,29.62407385605555
55771,2067,6,0,6,Q,28.95163915682575
169310,2068,5,3,8,S,28.878314522564764
102729,2067,5,1,6,Q,29.30964011492688
181668,2067,4,1,5,K,29.1590890008426
24394,2067,7,2,9,D,29.219525493766483
69956,2068,6,2,8,D,29.02742803926428
175944,2068,4,1,5,N,28.933151794383743
67522,2068,4,4,8,N,28.88430901513882
46633,2068,2,2,4,E,28.77147961414372
114953,2068,9,4,13,C,29.14286053933503
108713,2068,2,0,2,M,28.812306796577897
172063,2068,4,1,5,D,28.770981145978457
86292,2067,4,0,4,H,29.198799125687543
181425,2067,6,2,8,M,29.11549661878973
20920,2067,6,2,8,N,29.148532136567564
142904,2067,3,2,5,P,29.305838003690127
178377,2067,10,2,12,J,29.15554929167601
133927,2068,6,1,7,N,28.72552231497327
90153,2067,3,2,5,Q,28.9748300998301
99548,2068,2,2,4,J,28.73637365742213
136216,2068,2,2,4,E,28.78622196862809
86633,2068,2,2,4,H,28.839912401917328
114661,2067,3,1,4,J,29.460277276924028
47304,2067,7,1,8,N,29.127980339455533
132089,2067,2,1,3,K,29.188511213675906
88172,2067,5,2,7,M,29.15626810087748
51838,2067,5,0,5,J,29.132636234581728
160594,2067,4,5,9,L,29.32747008309447
26562,2067,6,1,7,E,28.975341756506644
169993,2067,4,1,5,N,28.96576475056344
65413,2068,5,1,6,J,28.9502709010159
92773,2067,7,3,10,N,29.15084289138124
116600,2068,6,2,8,E,29.232362271044725
38285,2068,6,3,9,N,28.94898458248994
27976,2067,6,0,6,M,29.478657682121845
161509,2067,6,1,7,N,29.19998947755015
171712,2067,4,2,6,Q,29.075902231580383
109349,2067,2,2,4,Q,29.381356303779285
172360,2068,5,0,5,A,28.867782835084345
182548,2067,5,1,6,E,29.131525116857947
76918,2068,7,1,8,M,28.929765996942358
76925,2068,2,3,5,E,28.682707465426077
161361,2067,2,0,2,E,29.125553167354862
144141,2068,4,1,5,P,28.597602105798263
57255,2068,5,2,7,P,28.90907286631848
32518,2067,3,1,4,E,29.357685495678105
19165,2067,3,0,3,K,29.16984570311257
56389,2068,6,2,8,D,28.69891391502623
121847,2067,6,0,6,K,29.344272679468855
176696,2068,3,2,5,P,28.634486826458957
39499,2068,5,1,6,J,29.01804169457605
16360,2067,3,0,3,D,28.94173618710478
148114,2068,5,1,6,P,28.816407218896945
38649,2067,2,1,3,N,28.997306958136317
77897,2067,4,1,5,M,29.285174923374683
97006,2067,5,2,7,E,29.023850474911438
114316,2067,5,2,7,M,29.192051029363174
160750,2068,2,2,4,N,28.89728089954856
101164,2067,11,2,13,D,29.25601584474412
100690,2068,7,1,8,J,28.713551246811267
48401,2068,4,0,4,A,28.907773958111463
166427,2068,6,1,7,Q,28.831535838419903
179334,2068,5,2,7,N,28.87346331197182
39091,2067,6,2,8,H,29.460821162515856
144502,2067,3,2,5,P,29.54165295690014
159198,2068,4,1,5,C,28.781131481401683
175448,2067,3,2,5,P,29.192272620941367
88877,2067,5,2,7,N,29.45847180761535
93156,2068,6,0,6,J,28.896170774007278
82603,2067,5,1,6,N,29.417119735642668
25169,2067,2,0,2,N,29.23951098981105
59854,2067,4,2,6,J,29.39500608868211
163965,2068,4,0,4,N,28.896909492929872
175701,2067,4,3,7,N,29.160359517122565
106396,2067,6,0,6,P,29.44559134241908
75441,2068,2,2,4,D,28.681031453053105
96077,2067,5,0,5,M,29.26229288711028
133691,2067,1,2,3,Q,29.16632899943886
69117,2067,4,2,6,M,29.251771401415567
119177,2067,2,1,3,E,29.30802536089321
176870,2068,5,1,6,N,29.075239512968576
45913,2067,5,0,5,J,28.9024640178995
138690,2067,6,2,8,N,29.297816507437624
71301,2068,7,0,7,D,28.85925622054738
171031,2067,4,2,6,D,29.105770208601506
60040,2068,7,1,8,Q,28.79561146093748
73131,2067,4,2,6,N,28.989161640491822
17318,2067,1,4,5,D,29.65840804576293
44623,2068,3,1,4,D,29.013243692328487
74710,2068,2,1,3,N,28.741620848936147
17054,2067,3,3,6,S,29.19448302911923
59698,2067,6,0,6,J,28.8605262595936
96102,2067,6,1,7,N,28.906774793402214
18170,2067,5,0,5,S,29.339589105086468
170882,2067,23,2,25,N,29.13241258184925
28121,2067,5,3,8,J,29.32220986606702
41219,2068,6,1,7,N,29.025879399904422
139452,2067,4,1,5,N,28.963717044578164
37581,2068,4,2,6,F,28.768502341484137
63830,2068,5,1,6,J,28.79884577119269
109205,2067,4,2,6,J,29.151094624445506
41001,2068,4,0,4,M,28.93459977734052
174009,2067,5,1,6,F,29.263796360524164
32793,2068,5,1,6,J,28.90161557848134
60042,2068,5,1,6,D,29.149869010817767
112460,2067,3,1,4,N,29.406238019417977
50294,2068,7,2,9,N,28.9061098962304
110291,2068,5,2,7,J,28.94434890215864
104672,2068,9,1,10,D,28.450196553515013
55139,2068,6,2,8,N,28.759989711636976
66693,2067,5,2,7,D,29.397012376607314
143509,2067,4,1,5,N,29.213569251198557
145494,2068,4,1,5,K,29.028457516737003
25121,2067,3,0,3,D,29.09466248178954
20039,2068,2,2,4,E,28.778171106820185
145176,2067,5,2,7,N,29.07783100504105
148941,2067,6,0,6,M,29.183311283140263
163392,2067,4,1,5,N,28.93237406772546
121933,2068,2,0,2,E,28.82708769192214
148055,2067,5,1,6,M,29.1857662908718
169361,2067,5,1,6,D,29.323792682340255
42675,2068,4,1,5,A,28.70285623882236
178489,2068,8,1,9,P,28.678018338679305
111363,2068,5,0,5,J,28.97536779267846
162377,2068,6,2,8,E,28.924647679509395
35892,2067,3,3,6,J,29.54840702495835
163432,2067,3,2,5,E,29.4707884889764
68306,2068,5,1,6,M,29.23171121512832
60125,2068,7,3,10,D,29.06218267951434
167144,2067,5,0,5,M,29.13514132778814
123586,2068,6,0,6,J,29.12429657915721
17854,2067,3,3,6,N,29.099883305249158
144414,2067,0,4,4,J,29.16933509350542
23655,2067,6,0,6,P,29.243579086208523
61583,2068,5,0,5,N,29.2759688964438
134631,2068,7,2,9,J,28.462145300336687
142964,2068,3,1,4,M,28.784207471999345
54827,2068,3,1,4,D,28.908539392718147
176851,2068,6,1,7,P,29.04992914203471
71565,2068,7,2,9,N,28.952041187987856
50252,2068,6,1,7,M,29.16825730475025
68429,2067,4,0,4,Q,28.822755687158843
113850,2067,2,0,2,J,29.22591769471568
172547,2068,5,2,7,Q,28.869730506258964
145080,2068,9,3,12,P,28.936700202850325
101672,2068,6,0,6,E,28.633355497103068
162788,2068,6,1,7,E,29.080665742932503
46525,2068,5,1,6,J,28.895300266255536
173486,2068,2,1,3,E,28.99551937314673
179154,2067,9,0,9,H,29.12553046681561
174432,2067,4,2,6,N,28.97186189719865
59990,2067,2,1,3,Q,29.120764137452703
122500,2067,5,1,6,J,29.291725688209347
157986,2067,5,1,6,N,29.1809551424866
162162,2067,5,3,8,J,29.282498539806024
125564,2068,5,2,7,J,28.910078203259783
83827,2067,5,0,5,A,29.36837599890032
40991,2067,7,1,8,S,29.402059954912087
133725,2067,9,2,11,K,29.21770129171108
27561,2067,6,1,7,E,29.088208423134663
123304,2068,6,1,7,N,29.23713736543757
86809,2067,2,2,4,E,29.078716311829297
77115,2068,5,3,8,M,28.96193817412031
28431,2068,2,2,4,Q,28.90613398798535
143587,2068,5,1,6,P,28.647080677018156
146379,2068,6,2,8,J,29.046078322099863
36352,2067,5,3,8,P,29.28074597193005
119002,2067,2,1,3,E,29.170630161287463
141960,2068,8,0,8,J,28.824496803625127
138097,2067,4,0,4,Q,29.10582522876133
86510,2067,5,1,6,R,29.33565595296045
116937,2067,2,2,4,E,29.16810809995891
135757,2067,4,2,6,J,29.165016134921373
78248,2068,2,1,3,E,28.63440736671301
150443,2068,6,1,7,M,28.83759653798878
66006,2067,6,1,7,N,29.13894103530105
144423,2067,6,2,8,S,29.38168337000397
75533,2068,5,4,9,S,28.75347333785391
100803,2068,5,0,5,H,28.86167413527108
36147,2068,3,1,4,P,28.61689476220309
16096,2067,5,1,6,P,29.19000776774613
21599,2067,5,1,6,N,29.41207729813046
86467,2067,1,1,2,J,29.24437786336511
114974,2067,3,0,3,Q,29.21072216096704
151037,2068,4,2,6,P,28.601389097649392
84401,2067,3,1,4,E,29.281845177259346
70302,2068,2,2,4,A,28.854912298886184
101042,2067,4,0,4,K,29.20246821607499
179367,2068,7,1,8,E,28.673232222506265
145973,2067,2,1,3,M,29.359317446117437
99548,2067,5,3,8,J,29.48404952611918
139251,2067,2,0,2,Q,29.168134357274447
179671,2068,7,2,9,H,29.121696964848223
23724,2067,3,1,4,R,29.403122215248477
88877,2068,1,3,4,N,28.633327664878173
171279,2068,2,2,4,D,29.003292025488776
132291,2067,7,0,7,J,29.012887736599843
26013,2068,5,0,5,E,28.40920868484591
168078,2068,4,3,7,M,28.92922598971821
21855,2068,5,0,5,Q,29.01953798286488
98543,2068,5,2,7,Q,28.80986679194689
145423,2068,1,2,3,M,28.805280379308087
74748,2067,5,1,6,N,28.966659003178968
178276,2068,3,3,6,N,28.578284873484684
66475,2067,7,2,9,Q,29.120145227495986
78001,2067,4,1,5,Q,29.12094844579756
95796,2068,2,1,3,K,28.60914251879402
25706,2067,5,0,5,D,28.993413451624143
28283,2067,3,2,5,Q,28.968260570022757
27744,2068,3,1,4,D,29.053268381474645
51990,2068,6,0,6,K,28.702908917692124
104646,2068,2,0,2,E,28.69831270911469
25521,2067,3,4,7,D,29.13422342448333
70783,2068,4,1,5,E,28.91010474306356
35897,2068,8,2,10,E,28.786807994326328
31198,2067,7,2,9,C,29.16660501708229
137925,2068,5,4,9,M,29.045156144791186
112063,2067,3,2,5,Q,29.316734142903805
78911,2068,3,3,6,S,28.848667027201657
69891,2067,4,1,5,E,29.128135998023755
156142,2068,3,2,5,E,29.04875928359745
167189,2068,3,1,4,E,28.91308667077507
182815,2068,10,1,11,D,28.78862796855568
167269,2068,7,2,9,L,28.870396527054613
50576,2067,4,2,6,J,29.039270318370622
165331,2068,8,0,8,N,28.845598545226164
67154,2068,6,0,6,E,28.787192387719003
94713,2068,3,2,5,Q,28.91637674786149
16129,2067,4,2,6,N,29.271710499540497
47288,2068,8,0,8,E,28.792686624773296
172219,2068,4,0,4,J,28.863851160181746
46232,2067,8,1,9,A,29.17536106794363
56951,2068,3,1,4,P,28.938169599600705
102723,2067,7,0,7,J,29.005334454549228
47209,2067,6,1,7,E,29.219637635073287
107748,2067,5,1,6,N,29.335762573450875
144113,2068,7,0,7,M,28.65544647050957
122743,2068,4,2,6,Q,28.67685348417209
105785,2067,6,1,7,N,29.16889603276783
67928,2068,3,1,4,E,28.838656320389504
72885,2068,5,2,7,E,28.987367241700674
125048,2068,4,1,5,E,28.870506374250585
157692,2067,6,1,7,Q,29.05407142876926
158204,2067,1,2,3,J,29.3144291435516
164080,2067,6,2,8,M,28.67379138099031
30767,2068,6,2,8,D,28.94529022353685
127962,2067,2,1,3,M,29.213373922600397
99701,2067,6,0,6,D,29.1050221567573
41574,2067,3,0,3,M,28.974923430359297
111224,2067,2,2,4,E,29.240498684016
158260,2067,2,0,2,Q,29.03192040924664
146234,2067,2,2,4,L,29.33706502970952
102398,2068,6,1,7,E,28.84635183034477
83257,2068,4,2,6,A,28.950016819934028
139466,2067,2,2,4,E,29.31161334357584
142374,2067,3,0,3,P,29.148875713953885
108438,2068,4,1,5,J,28.637993477263308
144146,2068,3,1,4,E,28.78357078182748
58932,2067,2,0,2,D,29.128394255838195
148779,2068,4,2,6,J,28.82758268412884
50150,2068,2,1,3,H,28.508789410681363
69392,2068,5,2,7,D,28.885491546148984
118865,2068,5,2,7,E,29.0937550019553
99011,2067,4,2,6,Q,29.1260676510727
20161,2068,1,3,4,F,29.154857467446725
109064,2067,4,3,7,Q,29.027293397704188
169213,2067,6,2,8,D,28.819018780524686
162590,2067,5,1,6,E,29.22409961697001
101973,2068,2,3,5,J,29.19150755560706
46232,2068,5,1,6,A,28.95286696063679
47205,2068,4,1,5,K,28.573117036252828
74285,2067,3,0,3,F,29.12796588154462
100543,2068,4,1,5,N,29.073040295316225
104292,2068,3,1,4,E,28.67332862564842
74418,2068,3,3,6,J,28.700067343830643
130621,2068,4,2,6,D,28.540066239031923
109220,2067,7,2,9,E,29.30481961597537
25311,2067,2,1,3,N,29.203027275591317
148983,2068,2,1,3,M,28.76561892855317
161388,2067,4,3,7,Q,29.17372611715154
32366,2068,2,3,5,E,28.70274735967644
96347,2067,7,2,9,N,29.206589959141187
140170,2067,2,2,4,M,29.39856131280209
150508,2068,4,1,5,P,29.111232361263
46389,2068,8,2,10,D,28.911249470350047
83631,2067,5,3,8,I,29.240398125293908
165464,2068,3,0,3,P,28.928621747661825
68404,2067,4,0,4,E,29.47906928730176
77996,2067,2,1,3,K,29.30606105203308
119385,2068,4,1,5,P,28.846093330328237
26252,2067,7,2,9,M,29.28138805346697
20866,2067,4,1,5,P,29.344443179930646
113199,2067,9,1,10,E,28.976678459361764
92348,2068,3,2,5,K,28.928137994663636
120863,2068,7,1,8,E,28.905247736341025
61638,2067,16,5,21,Q,29.34005818637564
100045,2068,5,3,8,M,28.916972978713428
117611,2068,4,3,7,P,28.646829960181883
103225,2067,6,2,8,P,29.094540642651427
175840,2067,5,2,7,N,29.12070143406059
165989,2067,7,3,10,I,29.07076334645321
168107,2068,4,3,7,M,28.84840016739057
52012,2068,4,1,5,Q,28.61747163890988
176899,2067,9,3,12,M,29.13402641353513
55372,2068,5,2,7,M,29.20357993168002
119651,2067,6,1,7,N,29.110953862099777
58697,2068,6,1,7,P,29.033730849051143
147336,2068,6,2,8,K,28.64736207417652
181944,2068,3,2,5,E,28.744394002028585
161193,2068,4,0,4,I,28.82350682670268
90494,2067,3,0,3,I,29.27157198116728
49789,2068,2,1,3,E,28.73915836568089
104992,2067,4,1,5,F,29.30394182477044
174285,2067,5,1,6,J,29.32284349801245
33821,2068,4,1,5,D,28.870154935375325
65623,2068,5,0,5,D,28.82103219852452
160800,2068,4,1,5,E,29.128768205796572
146438,2067,5,2,7,N,29.062065596500723
185005,2067,5,3,8,P,29.106564143769187
176647,2068,5,2,7,N,28.88423239317156
125331,2068,4,0,4,E,29.15363162067713
165078,2067,3,2,5,N,29.00809761187669
56455,2067,5,0,5,E,29.111806518645093
21387,2067,5,1,6,P,29.304283756219142
123628,2067,4,0,4,S,29.215722727947835
144974,2068,5,1,6,Q,28.60374809313449
18002,2067,5,1,6,M,29.34800175924535
30521,2068,6,2,8,N,28.862218313151278
170425,2067,5,1,6,D,28.94516599496709
164202,2068,6,1,7,M,28.85289381908318
38458,2067,7,0,7,N,28.70215480335992
97294,2068,5,1,6,P,28.99156593565967
140631,2067,1,3,4,D,29.186679446363847
77366,2068,3,2,5,J,28.42283604050333
102663,2068,4,0,4,K,28.75868781408826
81475,2068,6,1,7,D,28.91596596375326
24889,2068,4,2,6,H,28.697694313895557
148849,2068,4,1,5,M,28.87674510676222
63047,2067,4,0,4,M,29.15353889213895
132725,2068,8,0,8,M,28.686371818102
41313,2068,6,2,8,Q,28.82416134282852
24111,2068,5,1,6,E,28.97667011904036
17727,2067,5,1,6,P,28.997693091515654
182489,2067,2,0,2,N,29.269153574943264
180532,2067,3,1,4,P,29.266353788154685
123339,2068,2,1,3,P,28.81851932803101
22102,2067,3,1,4,N,29.084834730908945
55585,2067,5,0,5,M,29.15455657523424
84632,2068,2,3,5,D,29.00704801548588
108509,2067,2,1,3,Q,29.12314934973251
28310,2068,2,2,4,Q,29.388839929548787
148919,2067,1,2,3,M,29.35962451022047
162573,2068,5,2,7,E,29.10721527451784
143783,2067,4,1,5,P,29.34092471529635
111599,2068,5,2,7,P,28.914771535741767
143013,2067,3,2,5,N,29.33395612996281
20104,2068,2,2,4,M,28.673898149320323
73864,2067,2,2,4,N,29.183297300514145
27788,2068,1,3,4,Q,28.76070418597072
144557,2068,5,2,7,J,28.88148903971374
97131,2068,5,3,8,N,28.86069024550128
146931,2067,3,1,4,P,28.94232810209667
148744,2068,6,0,6,A,28.916565760253995
93257,2067,5,1,6,J,29.022623238321344
144137,2067,4,1,5,P,29.254935654350408
49973,2067,5,3,8,Q,29.179829527450217
52564,2068,5,2,7,Q,28.852128078852907
175054,2068,8,0,8,E,28.73013058456253
129974,2068,4,2,6,J,28.66352365051885
55883,2068,5,2,7,H,29.17673581923439
116705,2067,5,3,8,E,29.122091426575903
134645,2068,6,0,6,K,29.02137522170354
99561,2068,5,2,7,J,28.7625700034733
165510,2068,5,1,6,I,29.010469256518665
89932,2067,2,1,3,J,29.035281908746214
171932,2068,6,1,7,A,29.273877064923827
106118,2067,1,1,2,E,29.30216352394585
45730,2067,1,2,3,E,29.15756719748006
19523,2067,6,1,7,D,28.91450240363526
49372,2067,4,2,6,S,29.425625676519065
59134,2067,5,0,5,J,29.254571383053968
106229,2067,7,0,7,J,29.008970920462943
17756,2067,3,3,6,N,29.292745891073167
54264,2067,11,1,12,Q,29.38894529148376
74636,2068,2,1,3,E,28.80073928634489
78308,2068,10,1,11,E,28.85740120733754
145740,2067,4,3,7,E,29.128916744518865
159962,2068,2,2,4,N,28.82284154915184
164236,2068,2,2,4,C,29.004529323555364
32409,2067,6,0,6,E,29.266895520594318
125531,2067,7,1,8,J,29.491939884581488
45435,2068,2,1,3,R,28.95370995926757
60035,2067,3,0,3,M,29.233155540215588
51575,2068,2,1,3,N,29.02549500312476
28924,2068,3,2,5,D,28.626794186651743
180028,2067,4,2,6,M,29.373545901130697
117839,2068,4,2,6,J,28.89939275712444
70196,2067,6,1,7,N,29.27674787151265
127704,2067,6,1,7,K,29.01680731696009
120907,2067,7,2,9,E,28.90162540168574
46391,2067,6,1,7,N,29.461804611230068
22537,2068,5,1,6,D,29.056434492689668
92976,2067,3,2,5,N,29.207378255021958
26075,2068,6,2,8,D,28.633563549318943
30308,2067,7,1,8,E,29.12897178933016
67362,2068,6,2,8,E,28.93029629139443
173499,2068,8,3,11,F,28.71585460341734
157255,2068,6,2,8,M,29.002476278144748
79059,2068,7,0,7,D,28.84005741384703
160017,2067,3,2,5,A,29.18524838916126
177745,2068,2,0,2,N,29.09134409070326
111618,2067,8,0,8,M,28.793652275339777
64341,2068,2,1,3,J,28.888151744284254
169766,2067,6,0,6,D,29.40919805723152
119555,2067,2,1,3,P,29.454018383754
109033,2068,3,0,3,C,28.809135977772467
63827,2067,4,1,5,N,29.34526570171645
158590,2068,4,1,5,Q,29.26605199222418
171378,2068,6,1,7,D,28.917466656836
20223,2068,7,1,8,P,28.93325054883342
130725,2067,6,0,6,M,29.03918225708729
130955,2068,6,1,7,E,28.791786417632352
114205,2068,5,2,7,J,28.807502080135777
116320,2068,5,3,8,J,28.686130999131823
145028,2067,8,2,10,P,28.943402095916078
104779,2068,7,2,9,N,28.66547826239421
166405,2068,6,1,7,N,28.818292756094635
110815,2068,4,3,7,E,28.98720346560175
131710,2068,7,0,7,G,29.131140415912032
40276,2067,5,1,6,P,29.07657085983577
55929,2067,7,2,9,Q,29.02490083059872
90448,2067,3,0,3,Q,29.1637321977661
127269,2067,4,0,4,P,28.81815895286235
141906,2067,5,2,7,E,29.616820864763035
116146,2068,4,2,6,N,28.63369999062996
61496,2068,5,1,6,N,29.15237027327184
34369,2067,6,0,6,N,29.280989863286024
106842,2067,4,3,7,I,29.58921959737669
104312,2067,7,1,8,M,29.272904055200115
52654,2068,3,3,6,M,29.041749280265517
121961,2067,3,2,5,E,29.2253448388132
111227,2068,2,1,3,Q,28.734640581375697
180858,2068,6,2,8,D,28.680793001103485
121459,2068,1,3,4,N,29.111612699314723
175939,2068,3,1,4,F,28.64215663817421
157345,2067,2,2,4,N,29.315900634006727
74197,2068,3,2,5,M,28.947964651482103
22396,2068,7,1,8,M,28.91501447846122
122920,2068,6,1,7,E,28.965235454851364
29468,2068,10,0,10,D,28.747245361398345
104177,2068,12,0,12,S,28.86609051965719
66352,2068,5,2,7,A,29.29676520290093
37749,2067,1,4,5,P,29.224989191261415
99418,2067,3,3,6,K,29.089942662703148
98532,2068,5,2,7,S,28.764963510862152
122018,2068,11,2,13,D,28.9296617434332
111234,2067,6,2,8,D,29.17440963064993
63758,2068,7,2,9,P,28.654595117155324
150324,2068,8,1,9,M,29.022082840593967
78094,2068,6,2,8,Q,28.900230753905984
117585,2068,5,1,6,P,28.92009245083619
38504,2068,5,1,6,P,29.146078734495685
169213,2068,2,0,2,D,28.829907913427054
76250,2068,8,2,10,P,29.24080254203408
147374,2068,7,1,8,E,29.140182249979706
82188,2068,15,2,17,D,29.016236587114328
106702,2068,4,0,4,F,29.00742501718313
63089,2067,1,4,5,N,29.02181570429058
112746,2067,1,3,4,J,28.99296863543025
70833,2067,4,2,6,E,29.139075372029417
39538,2068,6,1,7,Q,28.61773715599789
85081,2067,7,2,9,M,29.39257486647747
31079,2068,5,1,6,E,28.95537180291201
149122,2068,3,4,7,N,28.999186656020925
138756,2068,6,1,7,D,29.08404064322244
110038,2067,3,2,5,Q,29.11563572005593
19100,2068,4,3,7,K,28.751948610042422
115590,2068,5,0,5,P,28.8603721279548
109483,2068,3,3,6,E,29.031581945138026
33795,2068,7,5,12,F,28.90306335165753
83158,2067,9,1,10,D,29.213651267164717
169863,2068,1,2,3,Q,28.637069614876417
16522,2067,6,2,8,P,29.165395114421425
34576,2067,5,2,7,L,29.17837700517469
106120,2068,6,0,6,E,28.949273725977523
92780,2068,8,0,8,S,28.75770668156073
136500,2067,1,2,3,Q,29.33367787130103
37005,2068,5,1,6,N,28.699122803477792
114498,2067,4,2,6,E,29.167523266765787
123181,2067,3,1,4,P,29.07867167540105
29474,2068,4,0,4,Q,29.03491560747753
64047,2068,5,2,7,E,28.456062614944774
169528,2068,4,1,5,E,28.903530411460626
61988,2068,3,3,6,N,28.86712820927926
101658,2068,4,2,6,E,28.793985582353983
90527,2068,4,2,6,M,28.86208701157552
30883,2068,1,1,2,N,29.027642137898155
95959,2067,6,1,7,E,29.408467670526367
113145,2068,2,1,3,J,29.079593209002248
93214,2068,3,2,5,N,29.207619329324928
174115,2067,4,1,5,E,28.821136272119084
114161,2068,4,1,5,N,28.879388897535232
130978,2068,5,2,7,E,28.789726351448195
147221,2068,3,3,6,M,28.668740083193168
77230,2068,4,0,4,D,28.599257912245044
71745,2067,4,0,4,M,29.3766496895734
36932,2068,3,1,4,N,29.10375840831441
96622,2067,2,0,2,N,29.0251475633957
122038,2067,2,2,4,P,29.052376894209065
131540,2067,1,2,3,M,29.201397773731586
72928,2067,4,1,5,K,29.313019474236103
133051,2067,2,3,5,N,29.42273696999231
59934,2067,6,2,8,Q,29.22628543423293
137246,2067,4,2,6,N,28.89588322615459
105858,2067,6,1,7,N,29.592791978643245
168303,2068,3,0,3,S,28.83575334660349
55384,2068,4,1,5,P,28.950368586417053
109664,2068,3,0,3,N,28.60668742467442
104479,2068,1,3,4,N,28.70971872297119
148172,2067,7,0,7,M,29.10672625362514
32463,2068,4,1,5,P,28.736238543412764
56421,2067,4,2,6,D,29.22865517589626
92366,2067,4,4,8,C,29.21781190435232
165890,2067,3,2,5,P,29.331718926869897
49826,2068,2,2,4,S,28.796415817561005
63453,2068,7,1,8,P,29.152459009943097
81586,2068,3,1,4,N,28.85916173918384
83479,2067,8,0,8,H,29.17204379948293
162396,2068,5,2,7,C,28.914905968221987
180505,2067,6,1,7,Q,29.123220888011765
141494,2067,6,2,8,J,29.195515903281372
22348,2067,5,0,5,Q,29.52802585587768
28677,2067,3,3,6,Q,29.20407011992909
41590,2067,3,1,4,M,28.970250916043398
74045,2068,3,1,4,D,29.099145749271056
64403,2067,4,0,4,H,28.89974322472657
48493,2068,3,3,6,L,29.191250022079853
66368,2067,5,1,6,Q,29.357036234328504
33369,2068,5,2,7,P,29.0883381192124
137755,2068,3,2,5,P,28.804801167226856
48700,2067,4,2,6,P,29.116107395850342
97006,2068,1,3,4,E,29.041595995408617
166383,2067,3,2,5,J,29.388894919474478
134011,2068,4,2,6,K,28.915695021817797
157511,2068,6,1,7,K,28.55934506387789
123601,2067,6,1,7,M,29.538217247875004
170888,2067,6,0,6,Q,28.96164201417619
105191,2067,2,1,3,P,29.217419875252155
89607,2068,7,1,8,D,28.6294172792408
64656,2068,10,3,13,M,28.946913216441164
164224,2067,6,1,7,M,29.16411715680649
71046,2067,7,2,9,N,29.326239716688285
146000,2067,3,2,5,Q,29.65472472931622
89665,2068,6,1,7,Q,28.977965559373228
45705,2068,4,2,6,E,28.724427972861637
66944,2068,6,1,7,A,29.28240683100886
127311,2068,4,1,5,S,29.073968741208247
117442,2067,3,0,3,E,29.565874432908373
128774,2068,8,2,10,E,28.59128626067193
149308,2068,4,2,6,M,28.733943401462103
161634,2068,3,2,5,M,28.84248402870305
86673,2067,8,3,11,E,28.924520611788665
166526,2068,4,2,6,K,28.993324318575016
182647,2068,6,0,6,D,28.76324780518441
71821,2067,4,0,4,E,29.141660161921777
51142,2068,10,3,13,P,28.969772381793742
134225,2068,7,2,9,N,28.86166669662592
145238,2067,3,2,5,P,29.132640817087083
140861,2068,5,2,7,M,28.916019932480264
61638,2068,13,5,18,Q,29.208606370663265
108848,2067,4,2,6,M,29.178798110678905
78155,2067,16,4,20,F,28.998362830407917
115191,2068,4,2,6,D,28.946578465123544
148238,2067,2,2,4,J,28.97932478883772
132527,2068,3,1,4,J,29.18977874503538
46533,2067,7,0,7,A,29.25095645405441
133511,2068,5,1,6,E,29.0341769719779
106165,2067,4,1,5,E,29.32362989561218
16605,2068,4,0,4,Q,28.85482513543848
44815,2067,5,0,5,E,29.19436942069484
42629,2068,7,1,8,Q,28.883195683293536
146462,2067,6,2,8,M,29.14404073395301
100443,2067,3,2,5,A,29.283564951870584
113722,2068,3,2,5,E,29.0747528735972
133200,2067,4,2,6,E,28.93795165524636
16898,2067,4,1,5,P,28.993831142169583
171384,2068,3,1,4,N,28.71267746077404
118575,2068,2,2,4,E,28.7176071357673
123684,2068,9,2,11,A,28.90956417140647
111205,2067,11,5,16,E,29.473886938561385
75346,2067,4,0,4,P,28.766229673458025
144359,2068,6,5,11,E,28.84666731944762
112534,2067,4,3,7,P,29.01368961125437
132127,2067,7,0,7,E,29.126077607738832
59020,2068,3,2,5,Q,28.82373597927882
183393,2068,2,1,3,M,28.684555387691848
166461,2068,2,1,3,M,28.91334485253876
53468,2067,6,2,8,S,29.340347499906905
127863,2068,4,3,7,M,28.84351810790853
104958,2067,5,2,7,E,29.190310843094213
168342,2068,6,1,7,M,28.762122015958653
179315,2067,3,2,5,M,28.865657783572345
166148,2068,5,3,8,Q,28.825191948292872
15877,2067,6,3,9,K,29.316518794450637
72812,2067,9,1,10,E,29.173691669462038
145117,2067,5,1,6,D,29.290009893576
70143,2067,2,2,4,D,28.995619437639423
53787,2067,3,0,3,S,29.263886386861326
151027,2068,3,4,7,P,28.737214885106063
71097,2068,4,1,5,K,28.7734462218744
179346,2068,4,3,7,E,28.832493932855265
135486,2068,4,1,5,E,28.7849023480019
19610,2068,6,1,7,D,28.35573927860936
21354,2068,0,2,2,S,28.708099029881105
125283,2068,5,2,7,M,28.837094603698198
161697,2068,1,2,3,Q,28.8214463303275
129870,2067,7,7,14,I,29.02716647424213
180129,2067,3,2,5,K,29.256995502705365
16974,2068,5,1,6,D,29.150137304054592
181381,2068,2,1,3,E,28.82948828188786
111982,2068,2,1,3,J,28.792398709965354
148512,2067,6,0,6,M,28.90408781261356
182364,2068,5,0,5,K,28.82086354486081
88276,2068,3,0,3,J,29.183619160920443
122837,2067,6,1,7,N,29.20665546711903
69381,2068,7,1,8,N,28.65804872423013
167363,2067,5,1,6,J,29.28122534298937
24163,2068,2,0,2,N,28.97419505345143
103603,2068,5,0,5,J,28.383106544723297
148154,2067,6,0,6,Q,29.23700274812097
20597,2067,3,0,3,J,29.2200815407381
49510,2068,6,2,8,Q,29.00950245216422
76179,2067,8,1,9,E,28.97843251379701
107571,2067,6,0,6,E,29.174505210090537
98701,2068,6,1,7,A,28.690010508826997
97647,2067,3,2,5,J,29.045675352823466
99756,2067,2,1,3,D,29.286666992026795
160428,2068,5,4,9,S,28.785284196431668
25268,2067,1,3,4,E,29.252384861177237
96930,2068,3,3,6,N,28.832858950412312
21719,2068,3,3,6,P,29.07408767704633
181810,2067,6,1,7,I,29.19263920350095
158281,2068,2,0,2,N,29.00423349625044
146998,2067,3,1,4,N,29.255380280375604
127308,2067,3,2,5,E,29.135046317326115
178341,2068,3,0,3,M,28.77890526524058
148279,2067,3,2,5,P,29.358082993809404
185018,2067,8,1,9,P,29.25445028824064
112385,2067,9,1,10,E,29.082404686737643
140855,2068,3,1,4,M,29.177575849180027
25514,2067,8,1,9,Q,29.021097971215635
144429,2068,7,2,9,A,28.74474040302218
46567,2067,1,3,4,A,29.093227471513675
170865,2067,5,4,9,C,29.065895631099004
122998,2067,5,0,5,J,29.450078050981237
62339,2067,8,3,11,D,29.164367734669064
82893,2067,2,4,6,S,29.112602819388712
111071,2067,6,1,7,Q,29.13630228728359
93696,2067,1,3,4,M,28.876944246092524
49000,2067,1,2,3,E,29.26847231282928
76982,2067,3,3,6,M,29.091357611915843
64804,2067,5,0,5,Q,29.3730943279966
180322,2067,7,1,8,A,28.83877984811839
169801,2067,9,0,9,D,29.326789024371227
88415,2067,7,0,7,D,29.121528448452334
114796,2068,3,2,5,E,29.07211156791757
145859,2067,5,1,6,N,29.291981803292696
50235,2068,7,1,8,Q,28.853655181543697
20743,2068,5,0,5,Q,28.62065400982241
50344,2067,2,0,2,E,29.257285067351315
170182,2068,2,2,4,N,28.907431846069805
166887,2068,4,1,5,M,28.78605303838159
90118,2068,2,1,3,S,28.56373015176661
171333,2067,7,0,7,J,29.269970286709597
137126,2068,5,0,5,N,28.87417373783454
82852,2068,5,1,6,E,29.015156926712702
164906,2067,6,1,7,P,29.22238433863217
140549,2067,3,3,6,P,29.296615716996563
49067,2067,3,0,3,K,29.3197983864263
144026,2068,3,2,5,M,29.026487075897144
37640,2068,2,2,4,I,28.849793034435866
171228,2067,3,0,3,N,29.266915864129736
92188,2068,4,3,7,J,28.68352590484806
73562,2068,6,0,6,J,29.056696318825374
101486,2067,5,1,6,N,29.278057742727928
125107,2067,3,2,5,P,29.331749082648415
47764,2068,2,1,3,N,29.09457067825747
28969,2068,6,2,8,H,28.73799828410889
107934,2068,5,1,6,P,28.85489177211333
67154,2067,3,1,4,E,29.067922765086305
51283,2068,4,2,6,Q,28.93985099510597
27094,2068,6,2,8,K,28.98693974786463
39157,2068,5,1,6,M,28.87341199607324
160613,2068,5,1,6,E,28.655452423177437
45346,2068,14,1,15,A,28.854217940627297
60339,2067,6,0,6,K,29.263242283817213
18077,2067,2,2,4,D,29.22911309316793
65035,2068,3,1,4,Q,29.05843938060575
167811,2068,6,2,8,M,29.10743287171243
170608,2068,3,0,3,N,28.48700536325448
116067,2067,3,3,6,K,29.432923452178617
29591,2068,4,0,4,C,28.86550209200391
106742,2068,7,1,8,D,28.68983293583989
82450,2067,3,0,3,E,29.00844905486572
139732,2067,6,0,6,J,29.23426366260674
69847,2068,5,2,7,N,28.814950559944464
86496,2067,3,2,5,H,29.07939642089155
142970,2068,3,2,5,M,28.84640152511487
174810,2068,3,1,4,P,28.72563573409275
97964,2067,6,1,7,N,28.97869780146944
175641,2067,4,1,5,E,29.13115645870432
113297,2067,5,2,7,S,29.187827202375296
141511,2067,2,2,4,E,29.050085328918545
145765,2067,7,0,7,M,29.376371230923343
38224,2067,5,0,5,J,29.08188605025297
131402,2068,1,4,5,N,28.95683815789776
31819,2068,5,0,5,N,28.93537786960748
131431,2068,7,0,7,N,28.6120187442604
20663,2068,1,3,4,N,28.477937743176746
137601,2067,5,2,7,P,29.03162622091211
176168,2067,5,0,5,N,29.36347262317853
143857,2067,2,1,3,N,29.324427359290542
163432,2068,5,1,6,E,28.657722605795627
81207,2067,2,0,2,D,29.526201376643588
31882,2067,5,0,5,A,29.17498180305845
124687,2067,3,0,3,M,29.16416801711238
172955,2068,2,2,4,E,28.9040081298582
34651,2068,6,1,7,K,29.23552283397552
133671,2068,6,0,6,I,29.12165504780531
83988,2067,3,1,4,E,29.069041744407382
137930,2067,7,0,7,M,29.008263511082976
134387,2067,3,2,5,M,29.19373645621049
185034,2067,5,3,8,P,29.084310965995567
108905,2068,3,1,4,K,28.90962289988732
111246,2068,2,1,3,E,28.95229183889054
169265,2068,6,2,8,P,29.049059145173068
118699,2068,8,2,10,K,28.515080485354385
109094,2068,3,1,4,N,28.715129252062773
103807,2068,2,2,4,A,28.812955146466766
95201,2067,6,0,6,J,29.13851749907237
104111,2067,6,4,10,P,29.227951334075676
68598,2067,3,1,4,J,29.21830638103822
65158,2068,5,1,6,D,28.80518427347088
125479,2068,5,2,7,N,28.78015476420237
109205,2068,3,2,5,J,28.927740473341064
74938,2068,5,0,5,D,29.051297898544213
77955,2068,1,4,5,N,28.73998241622964
99755,2067,4,0,4,K,29.422620616158177
64018,2067,9,2,11,A,29.304637128817333
133214,2067,2,0,2,K,29.20783441858156
73419,2067,6,3,9,N,29.293097157826157
33808,2067,4,1,5,E,29.5046971463895
136316,2067,5,0,5,Q,29.13696820588809
20503,2067,2,3,5,E,29.371826106948436
138320,2067,1,5,6,J,28.744284325108428
143966,2068,8,0,8,M,28.763972968493288
39350,2068,3,1,4,P,29.076685028642917
148291,2067,1,2,3,N,28.76435464507045
20574,2067,3,2,5,P,29.001457299025216
118922,2068,5,2,7,E,28.638207942390014
129315,2067,1,3,4,E,28.95541681226244
157052,2068,6,2,8,N,29.02918670765108
170865,2068,5,4,9,C,28.84430692364265
94119,2068,2,0,2,D,28.806119161222888
131587,2068,4,3,7,M,28.79462588196304
172462,2068,3,2,5,Q,29.14944793400212
93982,2067,6,0,6,D,29.210925777213184
146742,2067,3,1,4,M,29.2469640962502
99289,2068,4,2,6,N,28.67087195933322
56036,2067,3,1,4,E,29.2143868129393
183270,2068,4,3,7,N,28.760427249787394
98149,2068,7,2,9,Q,28.830711620089478
35346,2067,6,3,9,F,28.895289379196
171320,2067,5,3,8,Q,29.323022064092168
35533,2068,3,2,5,P,29.235834644706248
94453,2068,2,2,4,R,28.84615578299759
144026,2067,5,1,6,M,29.2276496834844
35281,2068,3,0,3,A,28.66031443453039
137538,2067,6,1,7,Q,29.03680190051947
144612,2067,5,1,6,Q,29.47392909560824
40336,2068,2,3,5,J,28.933200313562686
99452,2067,4,2,6,P,29.008230901946277
101303,2067,8,2,10,A,29.02066956872177
29085,2068,13,2,15,E,28.666654055945514
95006,2067,6,2,8,K,29.323729632047705
122507,2068,5,2,7,J,28.546195404322297
75576,2068,4,2,6,R,28.64826717377653
55434,2068,4,2,6,P,28.58625777850764
60214,2067,5,2,7,E,29.28597811883489
136198,2068,4,1,5,P,28.818660151971
149627,2068,6,1,7,M,28.91243818514017
33058,2068,6,0,6,A,28.939135949902575
122689,2068,4,2,6,E,29.041726151007847
67923,2067,5,1,6,J,29.59298939326464
42587,2068,7,1,8,J,28.59431005070491
156043,2068,8,1,9,H,28.908013021947543
99169,2068,1,2,3,J,28.945843159474062
103906,2068,2,2,4,A,28.974252823559883
165171,2068,4,2,6,P,28.80234951266556
89916,2068,2,4,6,C,28.820941953724788
94489,2067,4,2,6,E,29.467591580797297
37207,2068,1,2,3,P,28.873271461508217
62873,2068,3,4,7,J,29.000138260786237
66016,2068,2,1,3,N,29.179004925111265
107440,2068,12,5,17,A,28.53772471737041
117127,2067,2,4,6,E,29.470423404221812
131067,2067,4,0,4,E,29.22262549886736
41222,2067,3,3,6,P,29.087819069131815
97832,2067,3,2,5,N,28.859922736846347
96944,2067,7,4,11,J,28.97977458599935
59880,2067,4,2,6,N,29.00115753086253
120003,2068,32,5,37,E,28.895944338449567
84771,2067,5,1,6,N,29.50107382294088
93415,2067,3,1,4,P,29.056782522479917
33838,2068,6,1,7,Q,29.00305456132557
29201,2067,9,1,10,P,29.00690107562821
166064,2068,4,0,4,A,29.05358386642003
160475,2067,5,2,7,N,28.897400447100093
72812,2068,6,1,7,E,29.09514011635228
182011,2068,7,0,7,D,29.12856159052721
116664,2068,5,0,5,N,28.91464585132374
18870,2068,1,3,4,P,28.698388967050214
114168,2067,7,1,8,J,29.23537095626049
131860,2068,4,0,4,J,28.960184455566814
132020,2068,6,1,7,E,28.98654448690956
74285,2068,4,1,5,F,28.669079126060417
147937,2068,7,4,11,I,28.64829158438208
148223,2068,7,0,7,E,28.878066646985207
183056,2068,3,0,3,G,29.06894648481238
174424,2067,5,1,6,K,29.275572790896703
75797,2068,3,2,5,Q,28.73540849905005
127582,2067,4,1,5,E,29.2845609441191
120644,2067,8,0,8,N,29.15627436732928
106242,2067,4,3,7,F,28.97067047131686
166689,2067,2,1,3,E,28.977947434969767
73912,2068,5,0,5,K,29.155402445470617
91944,2067,5,0,5,E,29.112359985445107
133432,2067,3,1,4,A,29.45851829270982
116017,2067,4,2,6,E,29.089069483194507
129471,2067,11,2,13,N,29.080380269816576
105837,2068,10,0,10,Q,28.78996705550028
64097,2067,5,2,7,J,29.365562768707417
52272,2068,3,0,3,E,29.01115537730852
35751,2067,4,0,4,N,29.286616031480197
116999,2068,4,1,5,E,28.998169009325878
15980,2067,5,1,6,Q,28.95882729596634
48344,2067,4,1,5,D,29.29612215668665
65886,2067,6,3,9,K,29.51199280347164
108749,2068,5,1,6,E,28.730466068176995
112250,2068,12,0,12,E,28.976594382668047
159622,2068,14,2,16,Q,28.729808324334805
38099,2067,2,1,3,J,28.98728477568448
129528,2068,4,0,4,P,28.95900131885124
164552,2068,6,2,8,D,29.11670596378041
130441,2067,6,3,9,E,29.178826215004644
44826,2067,6,0,6,E,29.291516702940505
161223,2067,5,1,6,E,29.11117227599679
19739,2067,2,2,4,J,29.19084552838604
92508,2068,5,3,8,K,28.84250916101601
141971,2067,3,4,7,C,29.482947626626288
96112,2067,2,1,3,J,29.305703335041315
159428,2068,5,0,5,P,28.693583362629376
172133,2067,8,2,10,D,29.339123663576014
122139,2068,4,1,5,P,28.74373427322536
149493,2068,6,2,8,M,28.606575050349687
95915,2068,4,0,4,N,28.91389884727203
51136,2068,4,3,7,Q,29.207505322632283
111438,2067,4,2,6,J,29.214904119064716
121643,2068,2,2,4,E,28.49303530482113
166234,2068,3,1,4,M,29.259251150594768
63664,2068,25,3,28,E,28.93997704678343
173636,2067,7,2,9,E,28.85740822406432
72583,2067,4,1,5,H,29.290264776752107
144013,2068,6,2,8,C,28.508692031827184
137299,2068,6,0,6,P,28.957241522493955
92773,2068,8,3,11,N,28.843537270470737
123642,2067,6,1,7,Q,29.351966568924222
180341,2067,6,0,6,E,28.74293219608509
150562,2068,4,1,5,P,28.809836562269847
26151,2067,3,2,5,D,29.06515726929628
164372,2068,6,1,7,M,28.650836299983798
140629,2067,3,2,5,K,29.38596134090916
29553,2067,6,0,6,K,28.802539760462977
135322,2068,3,2,5,P,28.49680635698259
93408,2067,2,3,5,E,29.38772505561916
61757,2067,5,3,8,D,29.02392126813453
61657,2068,8,0,8,P,28.684710933921007
27478,2068,6,0,6,S,28.893743277341148
60848,2067,2,3,5,N,29.55123770667857
135230,2067,5,2,7,N,29.14989959497277
81565,2067,5,1,6,Q,28.84371924195756
118949,2068,4,3,7,Q,28.845946090519075
131320,2067,4,2,6,S,29.581772370027643
106881,2068,4,3,7,N,28.950759379538475
144996,2067,6,1,7,K,29.35082947126375
109396,2068,14,5,19,C,29.007108136395228
148817,2067,3,1,4,P,29.313336167877253
105727,2067,3,2,5,K,28.961599333425163
32846,2067,4,0,4,N,29.20525758415904
110444,2067,2,2,4,C,28.936598686733458
160099,2067,4,0,4,E,29.057778103252595
31108,2067,3,3,6,N,29.0458156620586
142687,2067,5,2,7,N,29.588975501578705
38193,2067,3,1,4,Q,29.101336095306383
114788,2068,6,0,6,K,28.65080609748752
103051,2068,3,1,4,N,28.58345731559429
26363,2067,2,1,3,Q,29.015870220974843
85557,2067,4,1,5,E,29.45548296883597
138517,2067,5,2,7,F,29.147121931253345
94733,2068,5,1,6,D,29.066018290029955
62882,2068,1,1,2,N,28.892570780329272
58898,2067,4,2,6,P,29.36084476731957
145885,2067,5,0,5,J,29.17187324136447
94123,2068,5,1,6,N,28.90107741208912
85618,2067,1,4,5,E,29.195755573451443
25099,2067,6,2,8,P,29.29647490713504
183064,2068,6,2,8,P,29.13779934005503
62882,2067,5,3,8,N,29.224500234644733
150019,2068,5,1,6,M,28.831438163634157
86291,2067,2,1,3,H,29.12551968546416
93716,2067,6,0,6,N,29.236649733706265
73369,2068,3,2,5,N,28.87050438533716
17255,2068,4,2,6,S,28.843823211323667
147642,2068,7,1,8,M,28.72318805409041
116999,2067,3,2,5,E,29.19945566642231
49595,2067,4,2,6,J,29.14140840381289
149379,2068,6,2,8,E,28.811792416075424
93642,2068,3,2,5,D,29.053894677641544
148508,2068,4,2,6,M,28.829292273904507
25424,2068,6,0,6,E,28.41306210828887
135092,2068,6,1,7,N,28.952938681958447
162889,2068,2,3,5,N,28.51902810738964
28321,2068,2,1,3,M,28.471048549139
57567,2068,4,2,6,S,28.76143778248316
94157,2067,1,2,3,J,29.18272231227768
115959,2068,6,3,9,Q,28.92918150397396
129171,2067,7,0,7,E,29.37469394314449
89620,2068,6,1,7,K,28.87025108841397
74541,2067,5,1,6,M,28.91006529022144
104983,2067,7,2,9,S,29.41504423560388
113674,2068,5,1,6,J,28.913435257459817
113219,2068,5,3,8,D,28.69160392936584
178261,2067,2,1,3,K,29.150533927849857
39138,2068,7,1,8,J,29.18435586734855
145780,2067,6,1,7,D,29.0876172385147
82901,2068,3,1,4,S,29.257981573352605
148772,2067,2,1,3,N,29.2865626254329
141335,2067,6,1,7,P,29.18447630186475
107122,2068,5,3,8,J,28.732192051655645
135546,2068,7,1,8,M,28.81200894814036
97380,2067,5,2,7,N,28.92409395729636
38282,2067,6,0,6,N,29.219824392141597
169736,2067,3,1,4,D,29.098355133175627
62411,2068,3,0,3,D,28.81685131836461
124757,2068,2,2,4,Q,29.078263086295248
103135,2067,7,3,10,Q,29.2367291733226
84646,2067,4,1,5,N,29.198628914916053
36368,2067,4,1,5,H,29.21314625417351
113256,2067,6,1,7,E,28.871604348311813
22719,2068,4,2,6,D,28.90919056639628
165179,2068,2,4,6,N,28.93533277555004
51509,2068,2,1,3,D,28.71075830259037
149471,2068,3,2,5,E,28.947779159362376
116805,2067,3,2,5,Q,29.073662139683808
112333,2068,6,2,8,E,29.089116728211195
105727,2068,4,0,4,K,29.01417311211133
98200,2067,5,0,5,E,29.09646562176255
157875,2068,6,0,6,D,28.965570244394904
167839,2068,5,1,6,N,28.810721655281217
117029,2068,10,7,17,A,28.91668774389292
69684,2068,5,2,7,K,28.64249670980771
120361,2068,6,0,6,J,28.709670325330507
148721,2067,2,2,4,Q,29.27011347859966
134439,2068,3,1,4,I,29.089535256185982
88846,2068,5,0,5,Q,28.97766434489771
29711,2067,3,1,4,A,29.520744540077192
176397,2068,6,2,8,G,28.674868010154576
63354,2068,7,3,10,I,28.64247375132396
142641,2067,3,2,5,P,29.250305862419022
121115,2067,6,3,9,M,29.119501689394365
96917,2068,3,2,5,E,28.773564355061552
174686,2068,1,2,3,S,29.127568089746084
148132,2067,6,1,7,M,29.17569499056225
172418,2068,10,1,11,D,28.67467889501146
147903,2068,7,1,8,M,28.71413799457305
124304,2068,3,0,3,E,28.78809555243964
25677,2067,2,1,3,J,29.177268540362224
67283,2068,10,2,12,E,28.782047820998866
76855,2068,3,0,3,M,28.87902205363408
48768,2068,5,1,6,E,28.89916815686492
20482,2068,8,0,8,P,28.718446952921123
86962,2067,3,1,4,N,29.410005940337943
138669,2067,6,3,9,Q,29.29320625511925
151290,2068,5,0,5,M,28.96535307443869
92585,2067,3,3,6,N,29.11039065292813
168377,2068,7,2,9,M,28.806194803300087
165835,2068,6,1,7,Q,28.890798649240608
162614,2068,5,0,5,E,28.95033473101929
49323,2068,2,0,2,N,29.123842671165423
39761,2068,8,0,8,J,28.816749432898177
113532,2067,6,2,8,J,29.30254593014915
125718,2068,5,0,5,J,28.688407551038345
71235,2068,5,2,7,M,28.74085445403404
139606,2067,2,1,3,M,29.316390583456315
171735,2068,2,2,4,P,28.647934066547798
64741,2068,6,1,7,C,28.91661573753264
130730,2068,5,2,7,E,28.93113800920187
136997,2068,6,1,7,P,29.02953185163758
157325,2067,4,1,5,S,28.915813637969205
67190,2067,5,0,5,N,29.39353728602333
88888,2067,7,0,7,G,29.212420489853905
66440,2067,5,0,5,A,29.204277567663
52142,2067,8,2,10,K,29.301961718911823
115556,2067,5,2,7,E,29.112058311857275
123514,2067,4,1,5,E,29.292919215307204
93414,2068,4,1,5,N,28.990270881869066
83601,2068,2,0,2,D,29.253487894368384
143702,2068,2,2,4,N,28.860087888282344
90030,2067,6,1,7,K,29.292709222299464
54827,2067,7,2,9,D,29.31030476790276
145100,2067,4,0,4,M,29.1917170274546
76042,2067,6,0,6,N,29.1080046666656
185033,2068,19,1,20,P,28.613130228148854
129980,2067,5,2,7,K,29.171698885118943
123268,2067,4,1,5,F,29.12285552144686
106569,2068,6,0,6,J,28.673768503419733
143591,2067,5,1,6,J,29.31708742649524
59324,2067,6,3,9,E,29.107669596734645
48493,2067,5,3,8,L,29.30201038267082
157155,2067,2,3,5,E,28.91144243046844
156453,2067,7,0,7,N,29.19155880803306
158709,2067,1,1,2,E,29.454375449085692
114423,2068,5,1,6,J,28.916049818267027
162673,2068,4,0,4,E,28.748038333953268
63980,2067,1,3,4,D,29.19508482099944
84711,2068,4,2,6,A,28.86872848944237
26594,2068,5,0,5,Q,28.651173333758592
164781,2067,6,1,7,Q,29.09673269542043
166629,2067,6,2,8,N,28.95249278266144
87089,2067,5,2,7,Q,28.922622395416827
87014,2068,3,2,5,N,28.922330105778475
171564,2067,3,1,4,J,29.27629780144476
181929,2067,3,1,4,Q,29.080049927841195
41906,2067,6,1,7,J,29.00708099540865
182531,2067,8,0,8,J,28.89922438993152
130483,2067,5,1,6,N,29.04305097530021
145761,2068,7,0,7,J,28.827484139882344
64401,2068,2,0,2,K,28.90850722044231
97349,2067,5,3,8,J,29.004980224218563
156414,2068,9,2,11,N,28.61932071035473
61888,2067,6,2,8,D,28.69046967478419
169335,2068,2,0,2,J,29.13768115700375
102749,2068,7,2,9,P,28.98886953081632
171782,2068,3,0,3,D,28.83225293927626
111901,2067,5,1,6,M,29.410986623766185
148720,2067,4,0,4,M,29.48171325049844
87984,2067,2,0,2,J,29.00948195363602
32228,2067,7,3,10,N,28.98743642894521
67844,2068,7,2,9,N,29.04391648496315
39637,2067,4,1,5,M,29.265371151827
161006,2068,2,3,5,J,28.697474274925284
114867,2067,6,0,6,J,29.135976503859123
62736,2068,5,3,8,J,28.879816781049648
181372,2067,1,3,4,E,29.16150661000272
25274,2067,2,2,4,E,29.19760137952849
145438,2067,3,0,3,A,29.06224292157066
175332,2067,4,3,7,R,29.389730594694893
109304,2067,3,2,5,P,29.378982532939585
99696,2067,4,2,6,E,29.327971053703365
75954,2067,5,1,6,D,29.42480149960124
99403,2067,5,0,5,E,28.96578379206815
159775,2068,7,0,7,N,29.06213395807005
18184,2067,9,5,14,F,28.93841856791064
56920,2067,8,0,8,Q,28.80066793222296
45745,2067,5,2,7,Q,29.287820125923425
49433,2068,5,1,6,M,29.05456959117478
185015,2068,7,1,8,P,28.71378340616038
44293,2068,2,2,4,D,28.72668746044096
97819,2067,5,0,5,Q,29.37935040501405
18347,2067,12,5,17,L,29.196149373529995
21988,2068,4,1,5,M,28.78068052413601
88146,2068,5,1,6,Q,29.137183898670084
30539,2067,2,1,3,E,29.09445065742867
170165,2068,17,2,19,N,28.968336619671668
112906,2068,7,2,9,M,28.55617522346047
170570,2067,4,2,6,J,29.283952109395607
145352,2067,6,2,8,M,29.11685708009668
147584,2068,3,2,5,M,29.01700333296213
56548,2068,7,2,9,Q,28.88166289183874
101148,2068,5,0,5,I,28.710307843051357
42729,2068,3,0,3,E,28.572988003464022
182233,2068,4,2,6,Q,28.90717468746644
112093,2068,3,3,6,N,28.66961907462965
111363,2067,6,1,7,J,29.48111611693213
158767,2068,2,4,6,J,28.81862162170483
86652,2067,2,0,2,E,29.7068497167774
143183,2068,7,0,7,P,28.940278715652227
49575,2067,4,1,5,J,29.14049663616928
109768,2068,7,2,9,E,28.390220493509688
99184,2067,6,1,7,Q,29.19415385293796
41424,2068,4,0,4,E,28.889017508791245
156192,2067,4,2,6,N,29.45099059986933
77650,2067,5,2,7,S,29.329074254635355
95812,2068,5,0,5,E,28.725842616087988
48289,2068,9,2,11,E,29.122209509530546
151257,2068,6,0,6,P,28.81699178795449
134703,2067,3,3,6,E,29.357369067443297
143742,2067,4,2,6,M,29.00649256769296
56317,2068,5,1,6,S,29.01566717071844
131522,2068,6,2,8,E,28.902266959673
171905,2067,6,2,8,J,29.386019656165672
132717,2067,1,3,4,E,29.3877357643124
136665,2067,6,1,7,N,29.352303906870937
185018,2068,8,3,11,P,28.894376199254083
82371,2067,2,3,5,D,29.18290696888917
166829,2068,5,1,6,D,29.005198439688694
114791,2068,4,0,4,N,28.751780063239558
133502,2068,4,1,5,E,29.19163504956783
146203,2068,8,2,10,N,28.91170655530442
123653,2067,5,1,6,E,29.046380657532552
17079,2068,5,0,5,E,28.62895481385288
137554,2067,4,1,5,N,29.396190035287376
18249,2068,1,1,2,Q,28.901153889197808
28899,2067,5,0,5,F,29.16937241528269
111467,2067,5,1,6,E,29.048004953172804
91594,2068,13,1,14,D,29.06734074257209
25483,2067,4,2,6,D,29.51161949587325
125509,2068,6,3,9,Q,28.57120717047219
51475,2067,4,0,4,D,29.159875056072615
48964,2067,4,3,7,J,29.33494500569811
171459,2067,4,1,5,Q,29.648773619055344
52654,2067,4,2,6,M,29.480195163655765
146892,2068,5,2,7,M,28.720100151575107
36842,2068,3,2,5,S,28.796433409600745
75770,2067,3,0,3,J,29.09786731971613
69637,2068,4,1,5,E,28.680042780762854
82262,2067,5,1,6,M,29.0921710472236
56918,2067,8,2,10,M,29.238482047530272
145390,2067,3,2,5,C,29.055457258293085
166302,2068,2,1,3,E,28.547256057833973
158431,2068,3,2,5,E,28.79369167959315
139598,2067,4,1,5,M,29.115037518394583
113753,2067,3,2,5,P,29.23963093360464
133146,2067,5,1,6,E,29.029899807327684
148376,2068,3,2,5,M,28.91717494865686
138134,2068,8,1,9,P,29.1907831095318
132594,2067,5,3,8,A,29.35901229724368
49982,2068,7,1,8,E,28.979117676928983
50879,2067,6,2,8,E,29.372461348607548
22296,2068,7,1,8,N,28.7339271496715
137372,2068,7,2,9,M,28.59524756807383
131718,2068,1,2,3,E,28.56672630357364
141703,2068,5,1,6,P,29.00441195094885
25406,2067,1,1,2,J,29.46498914695984
32388,2068,3,0,3,E,28.70648663806345
181033,2068,5,1,6,N,28.627033350047565
116184,2068,7,0,7,M,28.733385125874214
156239,2067,5,0,5,D,29.240634429965223
103558,2068,6,1,7,A,28.767000099092275
134229,2067,5,1,6,N,29.254061038800483
102401,2067,1,2,3,E,29.519776328889023
139491,2068,6,1,7,F,28.806963366025048
117176,2068,7,1,8,E,28.65874808310445
127030,2068,6,1,7,R,28.70482878955876
148261,2067,5,3,8,M,28.783555313359848
31577,2067,3,2,5,D,28.709078570236507
73122,2067,5,2,7,J,29.13636494528616
119652,2067,5,1,6,P,29.18951698951078
102211,2067,2,2,4,N,29.49283583171746
24186,2068,3,0,3,Q,29.073363227028647
61803,2067,5,4,9,E,28.773208383822872
72624,2067,4,2,6,M,29.15086274774087
95061,2068,6,0,6,N,28.576337363681336
123393,2067,7,2,9,E,29.17153337600997
114664,2067,6,2,8,P,29.21694802256736
142333,2068,1,3,4,Q,28.83221581488961
138736,2068,10,2,12,P,28.74913789019061
146635,2067,4,0,4,P,29.140713572876628
130432,2068,1,4,5,M,29.05598711663554
121664,2067,7,5,12,K,29.051550985718965
119835,2067,6,2,8,E,29.26462682237948
175770,2068,5,2,7,F,29.05789241877113
148649,2068,2,3,5,M,28.93094670843415
165283,2067,2,2,4,P,29.13176811039614
122598,2068,4,2,6,J,28.9991467785232
150138,2068,2,3,5,N,28.669779529219014
147609,2067,3,0,3,K,29.455473894076125
55738,2068,6,2,8,N,28.838982059500516
107005,2067,3,1,4,Q,29.1118201625171
180053,2068,4,0,4,M,29.067517061785253
44656,2067,4,0,4,D,29.185438452013106
23705,2068,4,2,6,N,28.38237116645534
137798,2067,4,2,6,F,29.1102356673414
116404,2068,7,0,7,J,29.023802986678945
118617,2067,4,2,6,Q,29.00025100586094
166024,2068,3,3,6,M,28.725805757978097
104741,2068,8,1,9,K,28.899231605368
170801,2067,4,2,6,Q,29.36781880291394
73736,2067,4,2,6,Q,29.41264001554663
32738,2068,4,0,4,E,28.80962498311977
94823,2067,4,1,5,N,29.52905952819331
131246,2067,5,2,7,P,28.933278064919104
158665,2067,2,3,5,E,29.035474114023945
92426,2068,8,2,10,I,28.85114515203801
159163,2068,4,2,6,E,28.72291629917904
76204,2068,5,2,7,Q,29.093085126494763
136599,2068,7,2,9,D,29.07627499829761
143242,2068,4,0,4,A,28.964120929812044
62063,2068,7,0,7,P,28.558633814860126
78396,2068,7,2,9,M,28.839607162588116
131085,2067,5,1,6,P,29.482221078283228
66795,2067,3,0,3,E,29.37325671926583
145151,2067,3,0,3,N,29.302056753608905
185030,2067,18,4,22,P,29.16350840001288
58658,2068,4,2,6,E,28.853469319434904
96378,2068,5,0,5,J,28.91382180131559
139205,2067,0,3,3,N,29.065561838057857
128383,2068,5,2,7,M,28.813384346512468
105171,2068,7,2,9,N,28.776729368428924
36364,2068,4,2,6,Q,28.64998711932105
40666,2067,2,1,3,S,29.228524069560645
156964,2067,6,0,6,D,29.00682308061745
171031,2068,5,1,6,D,29.15203512349363
132153,2068,5,3,8,N,28.927917899713187
26979,2068,6,2,8,E,28.820669862448668
122761,2067,3,2,5,J,29.12207745938543
64996,2067,5,1,6,K,29.10177204792865
38719,2068,4,2,6,K,28.744891634949298
29539,2068,5,2,7,E,28.893828559175823
142745,2067,7,0,7,M,29.11307546104721
150808,2068,3,1,4,M,28.68091882904848
143899,2067,6,0,6,J,29.05639108715767
147642,2067,5,1,6,M,29.35477418846437
44751,2067,7,2,9,D,29.348259724168592
135165,2067,6,3,9,M,28.69510547582894
52216,2068,6,0,6,P,28.642493194017494
28212,2068,5,2,7,J,28.659264220149204
25625,2067,2,1,3,D,29.04019112041712
45710,2068,4,1,5,D,29.05317599717084
120004,2067,32,4,36,E,29.204048818975743
82545,2068,11,2,13,N,28.56125602812962
30357,2068,3,0,3,D,28.587170064608788
59449,2067,6,3,9,E,28.94746246694572
122779,2068,4,3,7,G,28.881948158826347
181526,2068,7,0,7,J,28.662018098913997
55841,2068,5,2,7,A,29.14499049108924
142004,2068,6,1,7,M,28.66685648517193
129251,2067,6,0,6,N,29.17837167549879
147706,2068,6,0,6,C,28.76285335500009
150733,2068,7,2,9,M,28.925237413375392
62802,2067,3,2,5,E,29.298621685187346
131629,2068,5,2,7,S,28.42917558698237
74321,2068,5,1,6,F,28.920310800401097
82114,2068,5,0,5,E,29.31663108145071
106215,2068,2,0,2,K,28.81897461593512
143732,2067,3,2,5,P,29.145953189842043
60184,2067,6,1,7,Q,29.13466481057912
49061,2067,2,2,4,J,29.12871926606469
137101,2067,6,2,8,P,29.272542028814623
101973,2067,5,2,7,J,29.131149919893232
45612,2067,4,1,5,J,29.29199697318674
177804,2068,5,3,8,J,29.30930641038746
50645,2067,5,1,6,N,29.46929596568404
94900,2067,4,2,6,K,29.13655475730765
159831,2068,4,0,4,J,28.844257036820967
109155,2068,5,2,7,J,28.93270774682968
71515,2067,6,1,7,E,29.279404960459804
36329,2068,2,0,2,J,28.552931833053027
143217,2067,2,2,4,Q,29.452341198559807
145687,2067,2,2,4,N,29.422701110070104
70291,2068,4,1,5,N,29.1812335694046
52244,2067,4,1,5,N,29.128250806179494
93570,2068,8,3,11,J,28.77525645856454
76422,2067,3,2,5,C,29.191446467719203
160987,2068,5,3,8,E,29.040000441034124
86381,2067,6,1,7,G,29.41789179007558
23638,2068,6,1,7,N,28.898524126575676
164196,2068,5,1,6,N,29.11632638224013
140680,2067,6,1,7,P,29.254268159209133
159836,2067,6,2,8,D,29.207843939201272
50389,2067,2,1,3,E,29.20309202102309
112832,2068,4,2,6,M,28.81411836874849
18038,2068,8,0,8,A,28.82713491746573
149514,2068,1,2,3,N,28.66948475836889
47939,2068,10,1,11,J,28.76422213413815
145028,2068,7,0,7,P,29.10380710752517
41170,2068,4,0,4,F,28.79050720643929
24338,2068,4,0,4,A,28.956223628768143
133791,2067,3,2,5,M,29.34591371234017
123327,2068,7,0,7,N,28.82421992366366
71527,2067,4,3,7,E,29.23821410752534
25958,2067,5,2,7,Q,29.101868867467484
139499,2067,4,1,5,P,29.172933206869477
123954,2067,3,0,3,M,29.202685212853897
85117,2068,3,3,6,Q,28.73101715844925
47649,2068,3,1,4,N,29.025004819234347
56645,2067,4,3,7,N,28.849234850976597
145446,2067,3,2,5,Q,29.46162750898624
159163,2067,5,3,8,E,29.41674569878449
141864,2068,3,0,3,J,28.852184878118397
84240,2068,1,1,2,Q,28.81447241260564
113944,2067,6,1,7,P,28.961689195997533
36270,2067,7,2,9,Q,29.390800736472197
130439,2068,9,3,12,E,29.034265863895364
61991,2068,2,2,4,Q,29.03890550107529
117555,2068,3,0,3,S,28.757535770578784
49159,2068,2,0,2,Q,28.55061427679133
52669,2067,4,0,4,K,29.16715440729305
19986,2067,6,0,6,A,29.360291190278165
94315,2067,3,5,8,K,29.24015643632148
22336,2067,3,0,3,E,29.1979657820881
75818,2068,2,3,5,M,28.778416836331804
17602,2068,1,2,3,D,28.840511109589293
60699,2068,2,2,4,J,29.091741230575582
18698,2068,3,3,6,P,28.860326949553663
27854,2067,3,2,5,E,29.09259302642492
37913,2068,5,2,7,M,28.80650251362807
147234,2067,5,4,9,E,28.90413324799208
99190,2068,3,0,3,P,28.84994181152321
86381,2068,2,2,4,G,28.749521416135327
125108,2068,3,3,6,E,29.04643238507886
94368,2067,3,2,5,Q,29.407171020022904
148930,2068,9,0,9,N,29.072711610604145
174399,2067,4,1,5,D,29.40525649072688
132291,2068,6,2,8,J,28.90703361265288
92483,2067,3,2,5,Q,29.19476817305804
18004,2068,4,2,6,E,29.04023542435855
148552,2068,7,2,9,D,28.80268570181666
166216,2067,3,0,3,N,28.862350973447064
65918,2067,3,2,5,P,28.94495896512983
108425,2067,8,2,10,P,29.31817008296072
50273,2067,5,0,5,E,29.04188255366145
40842,2068,4,2,6,Q,28.94431868859998
98600,2068,5,2,7,N,28.868075075224382
35790,2067,3,0,3,Q,28.78174649570472
131941,2068,7,2,9,H,28.764813749532767
74683,2068,1,1,2,N,28.638027611599448
88031,2067,3,2,5,P,29.17728595400502
37561,2068,3,1,4,E,29.03520912136987
88966,2068,3,1,4,M,28.835865203991823
140788,2068,4,0,4,H,28.783023093645795
106701,2067,4,2,6,J,29.21515207244742
55646,2067,8,3,11,Q,29.13588652275653
22612,2067,3,1,4,M,29.06283264862066
147212,2067,8,2,10,P,29.30897723523492
74271,2068,7,1,8,K,28.75703622592372
170117,2068,8,3,11,D,28.895268537886743
181375,2067,5,2,7,G,29.09113391546666
88280,2068,6,2,8,E,28.64766099409962
69836,2068,6,1,7,A,28.840262257308847
77842,2067,4,2,6,D,29.065920564392663
103432,2067,2,1,3,J,28.7478675441042
164947,2068,6,0,6,N,28.90654939732354
32609,2068,4,1,5,E,28.762930440235
149169,2068,4,1,5,M,28.985897412348628
65639,2068,4,2,6,P,28.99089864227277
61138,2067,3,0,3,N,29.00762800197674
22442,2068,3,2,5,D,28.758276330297043
114478,2067,5,2,7,Q,29.258757296163463
77377,2067,1,3,4,N,29.18150556679868
60287,2068,5,2,7,N,28.618749849603248
172062,2068,6,1,7,D,28.852624527143977
97102,2068,3,1,4,E,29.180460847629924
158623,2067,6,0,6,H,29.342865609605973
47987,2068,2,1,3,Q,28.913433609169942
158534,2067,5,2,7,N,29.072486018399758
169981,2068,7,3,10,P,28.85115198257043
103916,2068,1,3,4,P,28.855148969608383
135597,2067,5,0,5,N,29.13285867070637
148913,2068,9,1,10,M,28.990615360048675
107809,2068,4,0,4,N,28.85415801436668
151518,2068,7,3,10,M,28.848734426397836
131671,2067,5,3,8,E,29.364745048882167
25100,2068,6,3,9,J,28.75658980583107
77703,2068,4,2,6,N,28.68484475778512
54245,2068,6,1,7,Q,28.885584634385403
121092,2068,4,2,6,E,28.724360815503672
157099,2068,3,2,5,Q,28.789368727228084
143946,2068,3,0,3,K,28.90370630467215
119405,2067,4,4,8,E,29.374754127190148
93935,2068,2,2,4,D,29.13321345493728
32244,2068,5,0,5,N,29.152229192439982
96603,2068,2,2,4,E,29.10475858506788
54737,2067,4,2,6,J,29.212755346555117
146091,2067,6,0,6,M,29.286609202987705
69297,2067,7,0,7,D,29.289449729610848
139090,2068,6,0,6,P,28.794731441003645
33093,2068,7,1,8,E,28.7735007346938
24613,2067,1,3,4,N,29.036836967757484
150469,2068,6,1,7,J,28.96453464203355
136578,2067,5,1,6,K,29.25589280128858
142141,2068,2,4,6,J,28.98733346002661
113962,2068,7,4,11,E,28.889200485626706
94474,2068,4,1,5,J,29.15500559050014
170025,2068,3,3,6,E,28.79996391860433
84226,2067,6,1,7,J,29.13370260890127
146766,2068,6,0,6,Q,28.760826369592813
75602,2067,6,0,6,K,29.0949671376991
78290,2068,6,2,8,J,28.80144316998027
130140,2068,7,1,8,G,29.123324540833934
113029,2068,10,1,11,K,29.066540296669448
20572,2067,2,1,3,M,29.36070273404089
114046,2067,4,1,5,E,29.323486399346454
120371,2067,4,2,6,P,29.324923137078887
181097,2067,5,0,5,D,28.885729447504044
122189,2068,3,2,5,E,28.42133863532996
148049,2068,1,3,4,E,28.831637216815352
87679,2068,5,2,7,Q,29.01295504951316
172669,2067,6,2,8,A,29.180326996072523
45048,2067,3,0,3,Q,28.94419456044277
40718,2067,6,1,7,M,29.05578132942514
100209,2067,4,2,6,M,29.06103826002062
15808,2068,6,1,7,D,28.74185306720824
18627,2068,6,1,7,P,28.77318518146389
47119,2068,6,0,6,E,28.72732598866236
166027,2067,4,1,5,F,28.94289726219329
141936,2068,9,1,10,Q,28.93794926148057
18294,2067,3,1,4,Q,29.269144871056632
155961,2068,3,1,4,N,29.042152662915232
59421,2068,3,3,6,J,28.91169135623449
166707,2068,5,2,7,Q,28.766115308224744
40118,2068,1,3,4,M,29.056420902328327
117898,2068,3,0,3,E,28.785331282174425
95758,2067,2,1,3,E,29.19233049457624
97820,2068,4,1,5,D,28.61278982657021
89851,2067,4,1,5,C,29.356219011590788
19886,2067,5,3,8,P,29.27319825221336
113762,2068,6,0,6,E,29.01835529359594
134928,2068,8,2,10,J,28.80830001011064
59464,2067,2,2,4,D,29.13541024315224
39190,2068,4,0,4,P,28.5588258865738
162216,2068,11,3,14,E,28.646649506037168
178827,2067,3,2,5,E,29.308656559040514
34327,2067,4,2,6,E,29.291663238302704
161570,2068,5,3,8,I,29.070098717623114
118849,2068,3,0,3,J,28.769844774116237
90670,2068,4,2,6,M,29.134595764236227
128226,2067,4,1,5,E,29.099125762111772
55636,2068,3,2,5,K,28.880604970686825
146522,2067,2,2,4,D,28.9953237866886
57340,2068,6,0,6,N,28.913387204237463
143416,2068,5,1,6,J,28.45232593542368
53928,2067,2,1,3,K,29.27788255723603
72928,2068,1,3,4,K,28.99421618410893
138093,2068,2,2,4,N,29.275038813872733
66742,2068,2,1,3,M,29.088088808608436
21321,2068,2,3,5,K,28.852999130115503
30911,2068,3,0,3,N,29.00740096447698
94897,2067,4,1,5,J,29.066973058839796
130646,2067,5,1,6,D,29.50287735671857
88371,2068,2,0,2,H,28.87663950843919
111764,2067,5,2,7,P,29.146868830812885
169969,2068,4,1,5,J,28.84078999216944
47637,2067,2,0,2,Q,29.12369433203576
19886,2068,3,2,5,P,28.725150299991903
31689,2067,5,2,7,D,29.109850948484983
31190,2067,4,0,4,P,29.153063455984253
171095,2067,4,0,4,N,29.215069322131917
144883,2068,3,2,5,M,28.5901373447472
118683,2068,5,4,9,J,28.857039554002817
104407,2068,5,4,9,L,28.331818382052194
148267,2067,5,2,7,M,29.35116429174965
78700,2067,6,1,7,Q,29.257429213089257
51516,2067,4,2,6,P,28.94709924743194
158672,2068,16,1,17,N,28.72141787169553
180032,2067,4,1,5,Q,29.015572670398324
106954,2068,5,2,7,J,28.840972139567064
81581,2067,5,3,8,E,29.50589854514729
76485,2068,8,3,11,K,28.766328527874077
89827,2068,3,2,5,J,28.91089378693997
45693,2067,3,3,6,N,29.087299318306584
158317,2067,5,0,5,N,28.988612130582997
181233,2068,5,1,6,E,29.008333401082496
128335,2068,4,2,6,S,29.014102078338382
144532,2068,2,1,3,M,28.816946141435388
148552,2067,6,1,7,D,29.00378574386325
86347,2068,3,2,5,E,28.897671099606715
175463,2067,4,2,6,A,29.251812760274664
158650,2068,3,2,5,Q,29.14403087084605
143505,2068,4,1,5,M,29.13039263537023
26822,2067,4,2,6,N,29.20722981078932
45121,2068,15,6,21,D,28.91344831683648
45906,2067,5,3,8,F,29.192588724167017
82930,2068,2,2,4,N,28.837234544381555
44868,2068,5,4,9,P,28.768531910633765
114311,2068,4,1,5,N,28.824551457192804
46880,2068,5,2,7,M,28.776375982450787
47980,2068,4,0,4,E,29.15817050535604
145347,2067,3,0,3,P,29.20570818703615
165366,2068,3,1,4,M,28.657159778120324
73696,2067,5,1,6,E,29.16216453885637
93203,2067,3,5,8,N,28.98500440403952
160173,2068,0,2,2,E,28.929475513517183
116006,2067,3,2,5,D,29.358430199556786
93509,2068,3,2,5,J,29.123379756692007
20722,2068,2,0,2,P,28.803742462587003
129355,2068,5,3,8,P,28.83306116292849
174356,2067,7,1,8,M,29.23671389266096
64291,2067,9,2,11,E,29.004835005882757
23422,2067,2,2,4,D,28.63720173611736
110325,2068,6,2,8,E,28.81701947529231
135612,2068,5,0,5,Q,28.83806972309257
23493,2068,6,1,7,Q,28.702986942548108
104366,2068,2,0,2,D,28.729081944500827
93554,2067,4,2,6,N,29.111060814363363
34904,2067,5,4,9,S,29.31806655434337
37001,2068,6,1,7,F,28.81693831691789
147746,2068,5,2,7,E,28.87310300913701
117817,2068,4,2,6,I,28.81424658445301
61650,2068,26,3,29,N,28.9143749149908
176965,2068,6,2,8,Q,28.865139248094632
144370,2067,2,2,4,Q,28.932818474539424
181810,2068,7,0,7,I,29.175146881401982
124368,2067,1,3,4,M,29.11493206928121
78263,2068,4,1,5,Q,28.83484213768364
49944,2068,6,3,9,E,29.113659564988104
118324,2067,8,2,10,H,29.24297575623434
22551,2068,7,1,8,N,28.845518416293093
77165,2068,5,1,6,P,28.906219196844976
127934,2068,2,2,4,J,28.76142681782433
146217,2068,7,3,10,L,29.16517391445281
182768,2068,8,2,10,M,28.860291271297008
95451,2067,9,1,10,D,29.315081324023065
29473,2067,8,0,8,E,29.40260762467834
100954,2067,4,3,7,D,29.260246511619776
140875,2068,5,1,6,Q,28.75463336116197
29318,2068,2,2,4,N,28.75044853972523
145705,2068,6,3,9,Q,28.80025880899841
39157,2067,2,2,4,M,29.35021706712558
129956,2067,4,1,5,N,28.910407629972045
132570,2068,3,0,3,E,29.06668075911661
166084,2067,2,2,4,N,28.899518123892324
17972,2068,18,3,21,P,28.718449947652825
89660,2068,6,1,7,E,28.815761122371452
16051,2068,3,2,5,P,29.19805880786737
106947,2067,6,2,8,K,29.42607704546988
97294,2067,5,1,6,P,28.969506810038627
64661,2067,2,0,2,N,29.07785581604481
26697,2068,2,0,2,N,28.755416607077414
158668,2068,6,1,7,E,28.894104452335068
113636,2068,7,0,7,J,28.699466005682805
102878,2068,5,3,8,J,28.871776927814608
148245,2068,6,1,7,M,29.04197320041144
179106,2067,4,4,8,M,29.283375958977928
84412,2068,3,3,6,N,28.875648670114217
143683,2067,5,0,5,E,29.29045875183632
75378,2067,4,0,4,J,29.108705230676023
18603,2067,6,2,8,M,29.03667819013168
29377,2067,9,1,10,A,29.458265895350195
115234,2067,6,0,6,E,28.87012259536589
170153,2067,3,0,3,N,28.978860841128363
86505,2068,2,2,4,E,28.45576906646283
63352,2067,4,0,4,E,29.28352683997205
160256,2067,7,2,9,P,28.88173129156749
135865,2067,2,2,4,J,29.482518797243056
63980,2068,3,3,6,D,28.65077484197441
55717,2068,3,0,3,E,28.734559360202567
87260,2067,5,1,6,E,29.31809333623998
178465,2067,2,1,3,E,29.285702974335013
132327,2068,7,1,8,M,28.54089650540972
147575,2067,3,2,5,M,29.197635694204056
175701,2068,2,3,5,N,28.946588703278607
146117,2068,6,3,9,A,28.74020450659478
145925,2067,8,0,8,M,29.28711321962457
42016,2067,4,0,4,J,29.40088313109241
22302,2067,4,1,5,M,29.08566463258704
86903,2068,5,1,6,E,28.80118001732692
144124,2067,4,2,6,S,29.32827595075378
179552,2068,7,0,7,H,28.736269267550902
73379,2068,5,1,6,D,28.742484627426027
86310,2068,6,1,7,K,28.79723456359455
87553,2067,3,2,5,N,29.155824637004915
159266,2067,10,1,11,E,29.357052175243496
167144,2068,8,2,10,M,28.82003795069302
81329,2068,5,2,7,N,28.971605567794928
90111,2067,3,0,3,Q,29.075050271059865
47565,2068,6,0,6,Q,28.901943093561133
19212,2068,5,2,7,J,28.82491001652215
157662,2068,7,0,7,N,28.876657686992584
49446,2068,5,2,7,E,28.8208338180391
170975,2067,0,2,2,C,29.12850622684476
104906,2068,9,2,11,M,28.786775218026467
160954,2068,4,1,5,J,28.57217689951454
92754,2067,5,4,9,A,29.262251963111343
17279,2067,3,2,5,K,29.16254436122255
151076,2068,4,2,6,M,28.841386145723423
102469,2067,6,1,7,E,29.01383754786789
51478,2068,6,1,7,J,28.978455020731467
124869,2068,6,0,6,K,29.00670835738728
133437,2068,7,1,8,J,28.93322906760054
49313,2067,1,3,4,S,29.11761077914696
144802,2068,4,3,7,D,28.981530891519533
112002,2067,4,2,6,J,29.286077818299297
137220,2068,3,1,4,P,28.846728005213382
107998,2068,3,1,4,K,28.7530091726792
144851,2067,6,3,9,P,28.94688565556834
59984,2068,2,1,3,D,28.64299227324879
55635,2067,2,2,4,I,29.402985898755663
134821,2067,2,2,4,M,29.031295848410213
21782,2067,3,3,6,J,29.121824939750752
119439,2068,1,3,4,E,29.158651758406183
70196,2068,4,0,4,N,28.92851472506825
141755,2067,4,2,6,J,29.10361313885816
171108,2067,4,2,6,N,29.22644896193279
180518,2067,5,2,7,H,29.05135936185929
88605,2068,6,2,8,D,28.86894253681653
172201,2068,3,1,4,D,28.93020959216164
150117,2068,3,2,5,E,28.73343730954493
141613,2068,1,2,3,K,28.694569743476272
49384,2068,6,0,6,K,28.66933499344206
16593,2067,6,1,7,N,29.07995611633458
177766,2068,2,0,2,F,28.658692441091244
113074,2067,4,2,6,Q,29.18862599469858
39086,2067,4,1,5,E,29.198372091197506
73227,2067,2,0,2,H,29.24314296755662
41705,2068,4,0,4,N,29.04965334462784
147014,2067,4,1,5,M,29.204890927066867
128470,2067,4,2,6,P,28.92815535071903
66632,2068,5,0,5,E,28.7583953850216
93340,2068,7,1,8,N,28.65513332042411
38077,2067,2,0,2,E,29.1467524092834
104997,2068,6,1,7,K,29.179149934568294
44669,2067,8,3,11,A,29.0491381024194
167820,2067,5,2,7,D,29.16334791977443
50310,2068,5,2,7,D,28.67738422843954
129746,2068,11,2,13,M,28.835812388202083
74622,2068,2,1,3,E,28.89962720262637
116395,2067,3,2,5,N,29.18991643461598
94062,2067,6,1,7,N,29.56920069313424
103961,2068,3,2,5,N,28.895863554467983
143949,2067,7,1,8,E,29.0190493106134
116842,2068,3,2,5,Q,28.48515102706848
72583,2068,4,2,6,H,28.83051471981088
37573,2068,3,1,4,K,28.823112560414437
46188,2068,14,3,17,Q,28.631455925793603
141299,2068,3,2,5,M,28.94290671009524
124093,2067,4,2,6,J,29.109975261363804
131356,2067,16,3,19,C,28.95526866423062
158347,2067,7,2,9,E,28.925961391707933
94740,2067,4,0,4,N,29.28309405817375
144929,2068,4,3,7,M,28.891356305871906
118080,2068,3,0,3,N,29.078102364520447
61232,2067,4,2,6,M,29.33662996314277
63137,2067,8,2,10,A,29.21487910087428
123283,2068,1,1,2,J,28.80928008933311
129415,2067,2,1,3,M,29.199292174556657
148440,2068,5,2,7,M,29.136279889003056
144115,2067,6,2,8,K,29.56384144510339
141781,2067,5,0,5,J,29.396557823473174
146071,2068,6,3,9,P,28.821508848948135
123775,2068,3,1,4,E,28.842367190760967
58822,2068,20,8,28,P,28.826788342986056
179023,2068,8,1,9,D,28.75856215002802
111325,2067,4,2,6,N,29.09356464223718
157698,2068,9,2,11,A,28.909681423436872
69447,2068,5,0,5,D,28.56196550387589
103253,2068,4,0,4,E,28.909180615795037
157424,2068,3,1,4,J,28.69557317000152
36602,2068,6,1,7,D,29.049704330889128
82543,2067,3,0,3,D,29.10027941636677
66408,2067,6,1,7,Q,29.313237820471866
88135,2068,3,2,5,M,28.90109757190125
56566,2068,6,3,9,M,28.9400483799878
148888,2068,0,3,3,M,28.53476617614877
20663,2067,5,3,8,N,28.827990516429363
68399,2068,3,0,3,E,28.87226274530774
180266,2067,5,2,7,M,29.30782766518022
179513,2068,5,2,7,Q,28.781024337144935
55710,2068,6,0,6,N,28.810931101853512
143844,2067,8,2,10,M,29.23720287953312
124904,2068,3,2,5,R,29.037650964702383
27088,2068,2,2,4,D,28.69946783580862
46698,2067,4,2,6,E,29.014871584631265
163086,2068,5,2,7,S,28.80406464319577
159929,2067,4,1,5,E,29.15578760615596
66451,2067,4,1,5,D,29.25287546673928
68038,2068,3,2,5,F,29.074848851193984
74846,2067,8,1,9,D,29.308360190462384
145150,2067,5,1,6,M,29.55020833660274
74160,2068,5,1,6,D,28.77137814136816
120088,2067,17,10,27,E,28.98546270169106
174991,2068,2,1,3,M,28.81041379137137
125566,2067,6,2,8,D,29.0215490674644
84237,2067,5,3,8,N,29.13603218485435
101739,2068,6,1,7,M,28.737749881208508
83971,2068,6,0,6,N,28.936772321068293
146938,2067,2,3,5,P,28.93665364583834
66978,2068,3,2,5,J,28.78908046222156
32216,2068,5,2,7,D,28.8177951251311
138814,2067,4,1,5,E,29.44724227243212
61984,2067,11,2,13,J,29.183264345220564
121666,2068,6,2,8,J,28.891209149500806
160471,2068,4,2,6,M,28.83057771540789
137286,2068,9,0,9,P,28.96124298523437
172092,2067,2,0,2,N,29.13465637952
145775,2067,2,1,3,M,29.313842571083605
149354,2068,8,2,10,M,28.780882894366957
83098,2067,6,1,7,N,28.94890863390573
171261,2068,3,1,4,Q,29.263049880033275
34500,2067,5,1,6,E,29.45873032233665
148498,2067,7,1,8,M,29.30397261211286
96798,2068,6,0,6,J,29.16784030794276
145187,2067,5,0,5,E,28.90158192398728
16873,2067,6,2,8,D,29.296333790413875
42366,2068,4,2,6,Q,28.79891759604544
18907,2067,2,2,4,A,28.836426902529368
73010,2067,6,2,8,D,28.96776041790405
64583,2067,6,1,7,H,29.400478440559976
145307,2067,2,2,4,D,29.308960988316983
147985,2068,2,3,5,K,28.767409804363165
179703,2067,7,1,8,E,29.0723601142144
50998,2067,5,3,8,J,29.10583311895768
20715,2067,3,0,3,E,29.18856292227252
76398,2067,3,0,3,K,29.27965434080236
121270,2068,3,2,5,P,28.912171922236205
23502,2067,2,0,2,J,29.07895204651501
46247,2067,9,1,10,A,28.95785542824408
149399,2068,4,2,6,M,28.602200909801788
142767,2068,2,1,3,M,28.703374888311643
176274,2067,4,0,4,P,29.190818820449103
24278,2068,5,3,8,N,28.815391885265093
159393,2067,3,1,4,Q,29.31545387749667
103768,2067,6,2,8,N,28.89949494233885
135831,2067,6,1,7,Q,29.254538073411176
158872,2067,5,2,7,P,28.91938093612849
71870,2067,5,2,7,E,29.41494732412917
29860,2067,8,0,8,N,29.035483867520465
132788,2068,2,1,3,M,29.05737983411929
109184,2068,3,2,5,J,28.864782212293427
30561,2067,9,1,10,P,29.24601993899703
113530,2068,3,2,5,S,29.17643516760372
20930,2068,6,2,8,P,28.637903325192447
76408,2067,7,2,9,E,28.869318738498755
54763,2067,2,2,4,N,29.26298441632968
107908,2068,2,2,4,E,29.435379874363456
63682,2067,8,5,13,J,29.26633390266963
20752,2067,2,2,4,M,29.61698161829191
64465,2068,5,2,7,C,28.954939965545893
17389,2067,2,2,4,P,29.51272068037061
90104,2067,2,2,4,I,29.103051538649154
47367,2067,3,2,5,Q,29.25217516947889
68520,2068,2,1,3,P,28.90381002279481
45168,2067,7,2,9,N,29.05892522474968
51559,2067,1,2,3,N,29.218689773598623
81329,2067,3,2,5,N,28.937195294197945
138877,2067,6,2,8,K,29.211076937846062
147374,2067,6,1,7,E,29.10689346990112
165584,2068,5,2,7,M,28.61819819285174
151008,2068,7,3,10,J,28.984574239273662
150667,2068,6,2,8,P,28.720408025212368
15896,2068,5,2,7,P,28.8925861481323
95550,2067,2,0,2,N,29.0216812912258
139505,2068,3,2,5,M,29.01909441090712
176899,2068,9,4,13,M,28.84776552670912
134829,2068,5,1,6,E,29.205974368723773
20129,2068,5,1,6,J,28.83800886626747
145423,2067,5,1,6,M,29.50789471556775
118534,2068,7,1,8,E,28.97242612496174
54021,2068,5,0,5,Q,28.9410628322832
101293,2067,2,1,3,I,29.29943341742135
18517,2068,2,2,4,Q,28.95603126026258
101027,2068,8,3,11,J,28.8137887759748
37599,2068,15,2,17,P,28.769547397037204
119827,2068,4,2,6,N,29.096484733514327
168042,2068,4,0,4,M,29.11992268311146
183659,2068,7,1,8,M,28.50990023019365
75260,2067,5,1,6,K,29.10458297637449
93552,2067,1,1,2,Q,29.231969535958257
148420,2068,3,2,5,M,29.111080909943453
127399,2067,6,2,8,P,29.400625437698984
20223,2067,8,0,8,P,29.233849298709945
24520,2068,2,2,4,E,28.95912014616149
123662,2067,3,6,9,E,29.496679418591302
117130,2067,6,0,6,K,29.10675849796621
103891,2068,4,2,6,S,28.85305215964875
85592,2067,4,1,5,H,29.23002915665184
111637,2067,2,2,4,M,29.23688169985544
25714,2068,2,1,3,E,28.86636049533488
145381,2067,6,1,7,P,29.404931868683946
78136,2068,6,0,6,P,29.082149851049472
75460,2068,4,1,5,N,28.696946402649843
114960,2067,3,0,3,K,29.199845728241076
170749,2068,5,0,5,N,28.96125258791393
51081,2068,3,2,5,S,28.69020250455866
163011,2067,4,1,5,P,29.48216804749637
76615,2067,6,1,7,P,29.161577065670404
146431,2067,7,0,7,F,29.28761930037698
145302,2068,5,0,5,K,28.752066328529576
71436,2068,4,3,7,M,28.879118174653215
78253,2068,9,1,10,E,29.021860842702445
76660,2067,7,2,9,D,29.184784743242503
129506,2068,10,0,10,N,28.80790526513335
180761,2067,3,0,3,N,29.15484960540913
19832,2068,1,3,4,J,29.062418635501125
128829,2068,4,3,7,P,29.17112864960209
142895,2067,4,1,5,N,29.42657954245209
130032,2067,6,2,8,P,28.983831995973592
119017,2068,5,0,5,E,28.66279550718425
169736,2068,5,3,8,D,29.162195585351206
111308,2068,1,4,5,E,28.765060094157626
50758,2068,7,3,10,F,28.89005103634853
39732,2067,6,2,8,E,29.31253235902973
58978,2067,3,3,6,M,29.57955886844582
144306,2068,4,0,4,M,29.215185978846467
97527,2068,8,3,11,S,28.877264593572782
52124,2067,2,2,4,I,29.33113535181805
167615,2067,5,3,8,N,29.12342665973189
90931,2068,9,1,10,M,28.75769488805166
76573,2067,4,2,6,E,29.1727531945889
146921,2067,5,2,7,M,29.383634373312148
47349,2067,4,3,7,J,29.05940143781516
81459,2067,5,2,7,N,29.28345435124828
87103,2067,3,0,3,Q,29.29617153482653
32234,2068,6,3,9,N,28.729048949067863
175623,2067,3,2,5,E,29.30297279769705
164840,2067,5,0,5,P,28.81401427541377
81434,2068,4,1,5,N,29.05328878682021
54337,2067,2,3,5,S,29.01191604590723
59405,2067,2,0,2,K,29.123536162225463
34293,2067,4,1,5,H,28.601202184274022
82368,2067,6,2,8,J,29.291806679180905
124485,2068,4,0,4,E,28.97630107680396
167689,2067,4,0,4,M,29.44915536679618
73800,2067,2,1,3,N,29.1363220275877
45300,2067,3,3,6,D,29.05234525502094
38822,2068,6,0,6,E,28.99264683675642
76398,2068,3,0,3,K,29.156883401891527
136578,2068,7,0,7,K,28.77816082550073
110771,2068,3,2,5,K,28.867249327162707
110534,2067,6,0,6,H,29.03211106879663
64609,2067,6,0,6,S,29.281831123817955
67062,2067,13,3,16,H,29.07253679402818
164368,2068,3,3,6,S,28.73819201244574
96008,2068,2,3,5,M,29.040550615301868
141432,2068,3,0,3,M,28.651610761520462
19225,2067,4,2,6,D,29.245645424693464
110534,2068,6,2,8,H,28.8390558896091
178328,2067,5,2,7,M,29.23318514791802
141036,2067,4,1,5,N,29.06386468788494
157090,2068,4,0,4,D,28.828031858421003
98109,2067,9,2,11,E,28.8936329827598
42424,2068,3,2,5,A,28.603785127785592
49002,2067,6,2,8,Q,29.474709641866276
108975,2068,5,3,8,N,28.9272476274775
92886,2067,4,3,7,I,29.35315981735337
83835,2067,4,4,8,P,29.2733907128605
55151,2067,5,0,5,M,28.98760842818048
121203,2068,3,2,5,M,29.240135791098027
38037,2068,4,1,5,E,28.813438335707247
148728,2067,4,2,6,Q,29.036231353202187
40158,2067,3,1,4,Q,29.453068069596284
141417,2068,4,0,4,J,29.216822617429106
32150,2068,4,2,6,E,29.12886453710047
51575,2067,4,2,6,N,29.04796298968828
83629,2068,4,0,4,E,28.51743517725573
100759,2068,2,1,3,Q,28.968112264367686
171639,2067,3,1,4,E,29.00770431912992
78181,2067,8,0,8,P,29.335238589406877
127406,2067,3,1,4,N,29.225631275482048
124399,2067,3,0,3,M,29.18277339081065
180503,2068,7,2,9,E,28.76419156748808
132064,2067,4,2,6,N,29.284308913055494
135504,2068,2,1,3,M,28.634538984943458
25876,2068,6,0,6,Q,28.850395828878536
165418,2067,3,2,5,P,29.189762121283437
112294,2068,3,2,5,N,28.83689609364029
55590,2067,5,1,6,E,29.230542924564286
46417,2067,6,2,8,N,29.478131439423045
124300,2068,3,0,3,M,28.893653849497227
170800,2067,2,1,3,D,28.93661345889968
144746,2068,4,0,4,C,28.84324785300295
182772,2068,5,0,5,M,28.853889747375803
171626,2068,4,0,4,N,29.047378650489403
157324,2067,1,4,5,F,29.070729534600268
98317,2068,7,2,9,N,28.76591628006449
166802,2068,6,2,8,E,28.962018647018372
81843,2068,6,2,8,E,28.93075244064158
162886,2067,4,2,6,M,29.12036840454121
173105,2067,7,2,9,L,29.19742729113012
22077,2068,4,3,7,N,28.7623554159086
92738,2067,2,2,4,Q,29.05083991382352
158204,2068,0,3,3,J,29.12799550852909
129927,2067,6,1,7,E,29.170163670421896
96230,2067,4,0,4,D,28.92489309636869
145538,2067,3,0,3,M,29.427052114126777
182550,2068,8,1,9,M,28.64984955707614
169956,2067,7,1,8,D,29.084578069374828
134944,2068,4,2,6,S,28.630739359623124
146318,2067,3,1,4,Q,29.322345122840336
59118,2068,10,4,14,Q,28.763569436424344
40158,2068,5,2,7,Q,28.72812176412045
83429,2068,5,0,5,M,28.811193231688645
108774,2068,3,1,4,K,28.702008426613947
73800,2068,6,2,8,N,28.602581482867866
18002,2068,2,2,4,M,28.718151565119012
78290,2067,5,1,6,J,29.436505092358
105714,2068,4,2,6,P,29.33449846125519
112463,2068,2,1,3,I,28.62944581196545
100355,2067,7,2,9,N,29.400294434962184
141495,2068,4,1,5,Q,28.94034360718416
114334,2068,6,1,7,J,28.982069120096185
174802,2068,7,4,11,J,28.99673363684495
169575,2067,6,1,7,D,29.40110711195788
114341,2067,3,3,6,I,29.178447464390715
133264,2068,5,1,6,M,29.418300059327283
113913,2067,4,2,6,J,28.93690976163212
97830,2068,4,1,5,S,28.808644702069525
125746,2067,3,2,5,N,29.151882677980456
128892,2067,6,2,8,N,29.322453022198022
156185,2068,4,1,5,J,29.036438043140407
25388,2068,5,1,6,N,28.787788379008717
165938,2068,1,1,2,M,28.827642823163547
24038,2067,15,2,17,D,29.15496425338691
159522,2068,5,3,8,I,28.943839577544523
111422,2068,6,1,7,J,29.045771117392917
24217,2068,1,1,2,N,29.19492173219024
56565,2067,6,1,7,S,29.445927913082294
49789,2067,4,1,5,E,29.452055964290555
111205,2068,15,6,21,E,29.010477289758157
95149,2067,3,0,3,D,29.1739952583354
105241,2067,3,2,5,M,29.230247973485056
89491,2068,7,2,9,P,28.865047139741403
107863,2068,7,4,11,F,28.873701608352697
116322,2067,2,1,3,N,29.17440227809551
146748,2068,5,0,5,Q,29.363965968056377
73295,2067,5,2,7,E,29.269298647701945
26532,2067,7,1,8,M,28.91843748636882
110488,2067,2,0,2,N,29.41123560908032
39027,2068,5,1,6,E,29.194463442337454
130336,2067,4,3,7,N,29.26282480872237
47833,2068,6,0,6,N,28.645311929340487
19143,2067,11,2,13,P,29.198384130427478
104226,2068,6,1,7,J,28.91047092500633
27729,2068,6,2,8,D,28.98296499803459
51041,2068,5,3,8,E,28.96043925065203
50588,2068,6,2,8,D,28.54817215632533
179703,2068,6,0,6,E,28.774079610326105
92760,2067,2,0,2,D,29.35294037687145
26320,2068,7,1,8,Q,28.926116766220645
94123,2067,4,1,5,N,29.115678602298345
83552,2067,4,0,4,E,29.112406974064974
38063,2068,2,3,5,N,29.16933950843068
112418,2068,4,2,6,I,28.58630286015275
130187,2067,5,0,5,F,29.119335676902875
45766,2067,6,0,6,E,29.045808046045256
175515,2068,12,2,14,D,29.06629077745874
58811,2068,1,2,3,E,28.699566978637492
32811,2067,5,0,5,I,29.42457848069246
93916,2067,4,1,5,M,29.151399514424394
84248,2067,6,2,8,N,29.36229197724805
26810,2067,4,0,4,P,29.459185089827677
38786,2067,5,0,5,E,29.196943670994138
113124,2068,4,2,6,J,28.754605731124627
109214,2068,4,3,7,S,28.91655873596695
28199,2067,7,1,8,M,29.444623953346824
156722,2068,5,1,6,Q,28.98113470768964
107418,2067,2,1,3,M,29.054450230376045
156415,2067,5,2,7,N,29.2429334528666
157963,2068,6,0,6,E,28.8902739993749
15898,2068,4,2,6,P,29.010013407011236
64927,2068,3,0,3,D,28.635234686164903
134387,2068,4,1,5,M,28.943494933381384
164712,2068,2,2,4,E,28.966817235791297
101381,2068,5,1,6,M,28.925787060169288
133710,2068,5,0,5,E,28.817401733906028
99982,2067,4,0,4,D,29.212744397682776
97737,2067,5,0,5,D,29.084300745749097
171374,2067,4,1,5,Q,28.99778887977625
97820,2067,3,0,3,D,29.248196586993316
74154,2067,7,1,8,J,29.151479585335963
21230,2067,5,1,6,M,29.10334083446712
149674,2068,3,0,3,M,28.762178420325583
149173,2068,1,3,4,M,28.832728172402543
38508,2068,6,1,7,J,29.1890826230827
105542,2067,5,1,6,E,29.129891778562605
134674,2067,5,0,5,Q,29.23444317546143
112410,2067,6,0,6,K,29.17733647480472
144898,2068,7,3,10,J,28.77772775458433
101637,2068,13,3,16,I,28.899471294511407
59679,2067,3,2,5,N,29.128681272364133
127343,2068,3,1,4,N,28.82852979901435
127407,2068,5,2,7,K,28.59490622319656
156600,2067,2,1,3,D,28.958546175698316
123866,2067,3,3,6,E,29.06463759377554
105036,2067,3,1,4,E,29.395136418861025
123248,2067,4,2,6,M,29.033290185158744
148836,2068,8,0,8,M,28.4873859905774
164661,2068,5,3,8,M,28.761999874782862
114207,2067,6,2,8,J,29.41215176042253
77842,2068,5,1,6,D,28.53213881375432
145323,2067,3,1,4,M,29.19050608642839
94822,2068,4,0,4,D,28.96999656979925
176362,2067,2,1,3,P,29.30967866508044
139029,2067,6,2,8,N,28.78936066162137
144824,2067,6,2,8,N,29.401452614019348
107613,2068,1,1,2,K,28.895250963814664
68952,2067,5,2,7,E,29.211792403441
121151,2067,6,2,8,J,29.08220191659006
102864,2067,6,8,14,F,29.07865783917683
82153,2068,5,0,5,E,29.140639723931468
148189,2068,4,1,5,K,28.88556932277916
23994,2067,11,2,13,Q,29.18119642727642
160974,2068,4,3,7,N,29.11229655855165
163207,2068,5,1,6,E,28.69139052215025
150876,2068,7,1,8,K,28.97278452921751
103034,2068,2,2,4,D,28.51175171231524
75345,2068,5,1,6,A,28.525189888616364
146528,2067,2,0,2,M,28.94967018756623
59070,2067,6,1,7,N,29.571807659698376
32395,2067,5,2,7,D,29.086789736586702
148790,2068,4,1,5,Q,28.693707751631997
27907,2068,4,3,7,N,28.81080855765372
62397,2068,3,1,4,P,28.906337425331333
76805,2067,3,2,5,M,29.324372114406927
132927,2067,9,2,11,E,28.966339644975776
63849,2068,3,2,5,N,29.226086084056167
148727,2067,4,0,4,A,29.30631005739976
98916,2067,7,2,9,N,29.031750238541097
145529,2067,6,2,8,E,29.086518022748272
93039,2067,3,1,4,D,29.437469401612468
67302,2067,5,2,7,I,29.04210666790347
47911,2067,4,0,4,P,29.221817447414
41422,2067,5,3,8,M,29.257539567390857
125531,2068,3,1,4,J,29.28451175237552
116381,2067,7,1,8,D,28.844164232859647
56371,2068,5,0,5,Q,28.8007522864336
106878,2067,5,2,7,D,29.186853771646227
67302,2068,6,0,6,I,28.68092519617196
65023,2067,4,0,4,N,29.175131667893957
27452,2068,5,2,7,D,28.833137892695
48699,2067,3,3,6,E,29.17515281936232
160393,2068,11,1,12,M,29.065116611367092
117260,2067,3,2,5,Q,29.253249760994617
156955,2067,3,0,3,N,29.352701755103023
72824,2067,4,2,6,E,29.270130804908472
116963,2067,3,0,3,E,29.036807638770924
68059,2068,5,2,7,E,28.6849491457099
75384,2067,5,2,7,N,29.2452996672693
172160,2068,6,0,6,D,28.80684908846576
77325,2068,4,0,4,E,29.17607655549879
181161,2067,7,0,7,M,29.42059532868577
118823,2068,7,1,8,E,29.01688999140661
101403,2068,12,3,15,D,28.798271980161736
32794,2067,4,2,6,E,29.18985157182462
68729,2068,2,2,4,D,28.578607410208512
177481,2067,4,3,7,E,28.938425260659567
147673,2068,5,2,7,K,28.79835817856031
178783,2068,3,3,6,P,28.9047348334588
50833,2068,4,0,4,E,28.82226846430273
58875,2068,6,2,8,D,28.48715856335718
86738,2068,5,1,6,G,29.06001805039869
70291,2067,4,1,5,N,29.38732114905698
118949,2067,3,2,5,Q,29.36504079920234
72326,2067,4,2,6,J,29.460194455609823
38628,2068,6,2,8,M,28.80050714024496
63664,2067,26,2,28,E,29.115943009257784
123600,2068,7,1,8,M,29.016462836768348
156672,2067,9,2,11,E,29.12502516990303
86085,2067,5,1,6,K,29.26432711996877
127101,2067,5,1,6,M,29.15161606174316
122166,2067,6,1,7,P,29.20870876688617
146827,2068,5,1,6,M,29.00357184181036
89536,2068,3,2,5,E,28.516181388350805
18714,2067,4,2,6,P,28.918214010117964
18806,2067,3,1,4,P,29.49429936190835
79659,2068,4,3,7,I,29.060819197291703
106521,2067,3,1,4,A,29.207327949158163
63798,2068,4,2,6,E,28.953143853958768
150868,2068,5,3,8,M,28.81037022728413
92659,2067,2,1,3,E,29.16901335191111
31981,2068,8,5,13,F,28.8216703762098
102435,2068,2,3,5,Q,28.866326619869994
38526,2067,6,2,8,K,29.079407684394237
148723,2068,4,2,6,Q,28.73641923497492
19589,2068,2,1,3,I,28.639814540756536
21540,2067,2,1,3,E,28.96963476415557
37843,2067,9,1,10,E,29.200160783170837
158344,2067,3,1,4,N,29.279235244842173
41309,2068,1,2,3,N,28.889019828917267
182018,2067,3,2,5,N,28.808472953679047
52573,2067,3,2,5,M,29.20471366799477
179077,2067,6,1,7,N,29.10710748037168
165198,2067,5,0,5,D,29.160048571135093
55371,2067,4,3,7,J,29.025868953796667
98519,2068,3,0,3,C,28.970098287153192
18010,2067,3,0,3,E,29.17379701857057
66411,2067,6,0,6,D,28.971922400357037
74124,2067,7,1,8,M,29.369692216421
144821,2068,4,1,5,M,29.14488432630401
158317,2068,4,0,4,N,29.210327263479364
148488,2067,7,2,9,M,29.10688588390262
67444,2068,4,2,6,N,28.63284685260011
92864,2068,7,4,11,E,28.99706683558484
136407,2068,5,0,5,M,28.78927845138442
84682,2068,5,2,7,K,28.942102845022344
141418,2068,3,0,3,Q,28.809806440638926
159911,2067,7,2,9,N,29.22116742820432
130527,2067,5,3,8,Q,29.33571958498204
170673,2068,5,2,7,M,28.863686746427675
156421,2068,2,3,5,D,28.87387657868271
33483,2067,6,1,7,C,29.27828918592302
65938,2067,2,1,3,E,28.93382263494324
130801,2067,5,2,7,P,29.18640883160835
173415,2068,6,3,9,Q,28.71301218538217
123488,2067,4,3,7,S,29.316428012876887
143122,2068,6,0,6,Q,28.91232555258719
82100,2068,2,3,5,D,28.73326340852684
83479,2068,10,2,12,H,28.70094931394981
37306,2067,7,2,9,H,28.91415574009163
87813,2068,4,1,5,C,28.820473691811006
61373,2068,4,1,5,N,28.77351656784632
17982,2067,10,3,13,M,29.350735801033
177033,2068,4,2,6,D,28.49306031810133
110611,2068,7,2,9,E,28.802738269270783
180978,2068,3,2,5,N,28.729944948517605
20969,2068,8,2,10,H,28.78169539164865
49431,2067,2,2,4,P,29.246862358509297
144416,2067,6,1,7,N,29.199245360540367
33240,2067,4,0,4,E,28.96206663009176
41332,2067,6,2,8,K,29.27568634565102
166447,2068,3,3,6,M,28.8059313600224
143683,2068,7,1,8,E,28.759882129037404
111822,2068,5,2,7,E,29.1524595934338
60087,2067,4,2,6,E,29.52580906335995
125582,2067,6,1,7,E,29.40367949398723
115917,2067,2,2,4,E,29.02780832542877
46463,2067,5,3,8,E,28.836377783382595
76154,2068,2,0,2,E,28.79748685010396
55262,2067,5,3,8,J,29.024834973634515
132790,2068,1,3,4,N,28.864199417179417
119978,2068,5,2,7,A,28.896779992239598
132835,2067,6,0,6,P,29.265558862534157
65846,2067,5,1,6,E,29.30884998398462
127831,2068,4,2,6,E,28.97055894206347
138099,2067,6,0,6,Q,29.20244560191164
159286,2067,4,1,5,N,29.33142376017506
138406,2068,4,1,5,M,28.571645652622323
30370,2068,3,1,4,D,28.770158119880275
92352,2068,4,1,5,Q,28.778501481918777
111524,2068,4,1,5,J,28.91353952651208
142302,2067,4,4,8,Q,29.018900028364836
111226,2068,1,3,4,J,29.121859628267508
143505,2067,7,2,9,M,29.072550758684063
157911,2067,3,1,4,N,29.57236549685691
122777,2068,6,0,6,E,28.87479998454687
182362,2068,7,2,9,Q,28.997037168728525
120770,2068,5,2,7,P,29.175928387807893
114716,2068,7,2,9,L,28.77899419791424
46214,2067,6,1,7,S,29.261145509333616
93916,2068,4,3,7,M,28.91806704937451
19212,2067,7,1,8,J,29.114330426276755
138718,2068,6,1,7,M,28.946535055288532
107985,2067,7,2,9,D,29.43948377626405
161055,2067,4,2,6,K,29.22978049155988
35354,2068,10,1,11,E,28.844660463439617
160167,2068,6,0,6,S,28.85041780025861
131243,2068,5,2,7,Q,28.87525678726552
134699,2067,5,1,6,E,29.144325693053503
155897,2068,1,3,4,J,28.9613540672344
144151,2068,9,1,10,C,29.26415784213801
16154,2068,1,1,2,J,29.029292132375453
48346,2068,3,2,5,Q,28.8631238771028
157262,2067,6,1,7,A,29.111806345944437
134502,2068,2,0,2,P,29.105941747343515
23431,2067,6,0,6,Q,29.17144333012022
150605,2068,2,3,5,C,29.140737564541155
108237,2068,6,0,6,E,28.74136227161469
61757,2068,10,3,13,D,28.94813008544403
49570,2068,1,1,2,J,28.91611582983219
110281,2068,7,0,7,E,28.572913478225477
36188,2067,3,1,4,J,29.322891033848727
166246,2067,9,1,10,K,29.058051943683022
89574,2068,3,1,4,N,28.92842653799532
172412,2068,5,3,8,D,28.974764933071327
161747,2067,3,2,5,J,29.277630746548216
139287,2068,2,1,3,Q,28.807781313852647
147578,2067,7,1,8,M,29.093444430444357
95430,2068,1,1,2,J,28.83707013103789
25630,2067,2,2,4,E,29.098932416231342
144327,2067,1,3,4,P,29.34082512504966
58971,2068,3,1,4,D,28.687819987463524
127617,2068,2,2,4,J,28.92851082514664
140214,2067,4,3,7,P,29.423043407516214
157160,2067,6,1,7,E,29.006387851332967
147909,2067,5,1,6,M,29.415856948243167
56451,2067,7,2,9,N,29.2915072316414
175253,2068,1,1,2,N,28.663908267392795
91967,2067,3,2,5,J,28.916458033048198
59940,2068,6,0,6,P,28.84338109041789
45733,2067,2,0,2,D,29.14597337157893
181033,2067,4,3,7,N,28.753186009716387
179068,2068,6,2,8,E,28.650037429849743
123212,2067,5,3,8,M,28.798704106607484
69378,2068,5,2,7,K,28.86079560321552
121833,2068,7,2,9,M,28.67839370651601
149477,2068,7,2,9,P,28.52575797060458
166506,2067,7,1,8,I,29.183012377753744
82147,2068,9,5,14,J,28.71919180510804
137636,2068,3,0,3,J,29.247495715394884
137672,2068,6,2,8,M,28.602662253844947
77123,2068,4,2,6,M,28.86767259858208
102838,2068,6,1,7,P,29.10104691688577
93605,2068,5,0,5,N,28.68760904438144
77965,2067,5,1,6,Q,29.131904951966824
59854,2068,4,3,7,J,29.197010039635856
60607,2068,5,2,7,P,28.7747644973576
136316,2068,6,0,6,Q,29.099343976599105
75431,2068,5,1,6,M,28.821501613802475
135261,2067,2,0,2,M,29.21977224768011
63273,2067,6,1,7,J,28.789607906987165
101727,2068,6,2,8,J,28.65434272587145
49323,2067,2,2,4,N,29.25144627318008
110038,2068,8,0,8,Q,28.550356618062292
137015,2067,7,2,9,J,29.343477659858426
146668,2067,4,1,5,M,29.08861346077064
62451,2067,4,3,7,C,29.300421156974053
105202,2068,6,1,7,P,29.0818911664918
158019,2067,8,2,10,H,29.271399182446068
140063,2067,4,1,5,N,28.995577123999297
25897,2068,5,2,7,E,28.72882693804944
171337,2067,2,1,3,Q,29.61579183951916
125291,2067,5,0,5,Q,28.999117822121203
139252,2068,2,2,4,P,29.20636468763547
136212,2068,6,1,7,M,28.72561046860492
181040,2067,4,1,5,J,29.10929476054589
178793,2067,3,1,4,E,29.111271439875832
132614,2068,3,5,8,C,28.98262275553698
132827,2067,4,1,5,Q,28.90924479740934
114253,2068,7,3,10,E,28.823426715091877
94440,2067,2,3,5,N,29.070232557780955
172596,2067,6,0,6,E,29.372268740373933
24687,2067,5,1,6,D,28.96442190696779
114377,2068,7,1,8,E,29.21473926818708
156293,2067,3,2,5,P,29.51850817257963
137749,2067,6,3,9,J,29.32807969688075
40586,2067,6,2,8,E,29.55333803868352
104070,2067,4,0,4,E,29.47565931105174
176168,2068,5,2,7,N,29.17712244644106
68037,2068,6,0,6,P,28.84311377981149
129923,2067,2,2,4,I,29.412774710447927
122306,2067,7,2,9,S,29.193380688890528
45830,2067,4,3,7,D,28.84478778649321
90015,2067,2,2,4,M,29.11285935447972
36616,2068,3,1,4,J,28.76914491476689
96456,2067,10,1,11,N,29.36102193644149
145356,2068,5,2,7,N,28.700349345952606
140036,2067,3,1,4,M,29.11613382864
157119,2067,1,3,4,M,29.32732054589218
121406,2067,1,1,2,Q,29.39302500377119
181598,2068,5,1,6,Q,28.68799500907048
90885,2068,4,1,5,N,28.89439698444441
108829,2067,17,2,19,C,29.487687188826037
183105,2068,5,0,5,N,28.686740609168748
148261,2068,4,1,5,M,28.87383008763996
32598,2067,1,3,4,D,29.069792149759014
182981,2067,5,1,6,E,29.4769889495662
113825,2068,4,2,6,P,28.88144065004664
109024,2068,4,1,5,N,29.07696144455541
135868,2068,6,3,9,Q,28.773228787209703
55018,2067,6,2,8,M,29.073596804698006
146855,2067,4,2,6,K,28.869532569361667
108425,2068,6,0,6,P,28.86625785529168
86017,2068,4,0,4,P,28.85343865089639
157661,2067,9,3,12,E,29.017602724387267
140575,2067,3,1,4,P,29.25934345466925
131387,2067,6,1,7,J,29.207877013144728
56601,2067,7,0,7,M,29.08452751218729
23568,2068,4,3,7,N,28.864310311857157
51732,2067,3,1,4,E,29.183574889453933
102590,2068,3,1,4,E,28.98980279760673
53134,2068,4,4,8,M,29.02970031459885
51990,2067,5,2,7,K,28.897345391483565
88322,2068,6,2,8,S,28.68972432652316
137592,2067,3,2,5,D,29.34719532851945
72705,2067,8,5,13,I,29.155071409818888
158427,2068,2,2,4,E,28.794776131659688
97791,2068,4,4,8,F,28.653994479263133
82437,2068,6,1,7,P,28.818310985892083
35419,2067,6,1,7,K,29.29494305700072
59848,2068,6,0,6,E,28.726135557463152
86036,2067,6,2,8,E,29.132848684666996
99789,2068,3,0,3,Q,28.95094602429504
21343,2068,9,2,11,Q,28.94492269352369
101338,2067,5,2,7,Q,29.485879724115577
40947,2067,3,1,4,N,29.310278912798104
57601,2068,5,0,5,N,28.819254736819065
64115,2068,2,2,4,D,28.839807317539947
21907,2067,5,1,6,K,29.454499784918163
145165,2068,7,1,8,M,28.783485908416843
71650,2068,9,2,11,E,28.917105645921268
65379,2068,3,2,5,D,28.66786712543892
111232,2067,3,3,6,E,29.06217546143606
172547,2067,5,2,7,Q,29.088865334055395
86389,2068,2,2,4,Q,28.85048859672148
73096,2068,2,0,2,D,28.486853700396505
147663,2068,2,2,4,M,28.54742323447316
144202,2068,5,3,8,A,28.89554168489982
56787,2068,6,2,8,M,28.552826475738733
167026,2067,3,0,3,S,29.239753502961797
86965,2067,5,2,7,C,29.12848931984864
73725,2068,5,0,5,E,28.94829716206883
142287,2067,5,0,5,E,28.60668777197348
146528,2068,3,1,4,M,28.49720328579049
161806,2068,1,3,4,N,29.063076851411488
60607,2067,5,1,6,P,29.34256745551519
159629,2068,2,2,4,Q,28.935013822659226
46895,2068,9,1,10,A,29.032466188105797
114757,2067,7,3,10,Q,29.16175268635308
99342,2068,3,0,3,N,29.046775559224
53523,2068,3,2,5,K,28.98549119436249
112202,2067,6,2,8,Q,29.39539527218036
72017,2068,2,2,4,C,28.818667276049805
65238,2068,3,2,5,D,28.926501292287977
62210,2068,4,3,7,N,28.924090020348576
46061,2067,5,0,5,P,29.55908995246598
168246,2068,6,2,8,K,28.770451104163364
25865,2068,6,2,8,Q,28.88824051345069
81787,2068,3,0,3,N,28.73075099226922
165812,2068,6,0,6,N,28.633433950210133
170980,2068,5,1,6,K,29.03344738498421
53908,2067,6,3,9,J,28.992543035573707
64312,2068,5,2,7,D,28.517837337725883
17126,2067,4,3,7,P,29.239597332395856
106850,2067,6,1,7,K,28.96363634083502
35849,2067,4,1,5,E,29.371273575183228
71375,2067,7,0,7,D,29.069644303830785
61834,2068,4,2,6,E,28.63044437940373
112507,2068,5,1,6,N,29.105913811962115
36763,2067,4,1,5,N,29.096111333291702
60650,2067,5,1,6,R,29.25409972923809
131923,2068,7,2,9,D,28.92193547893916
47175,2068,4,0,4,E,28.917546793934
38730,2068,4,2,6,E,29.24329992637228
63102,2067,2,1,3,N,29.35961572769249
40835,2067,5,0,5,M,29.032118189442688
53374,2067,2,4,6,J,29.250855110136936
135305,2067,7,0,7,K,29.123904292615524
146297,2068,3,1,4,M,28.70593500371492
69239,2068,7,2,9,E,28.55204192327323
173237,2068,3,1,4,E,28.77040678297084
139611,2068,7,2,9,M,29.004926364165744
17175,2067,4,1,5,P,29.16040946534273
101429,2067,8,2,10,D,28.934476667240748
122455,2067,4,3,7,D,29.061742102589395
88618,2068,6,0,6,N,28.878034464049044
111054,2068,2,2,4,N,28.95459275082626
105365,2068,3,0,3,P,28.993951639059816
123114,2068,6,1,7,D,28.939858814600885
124074,2068,2,3,5,N,28.727763295386836
26836,2068,4,2,6,Q,28.831581664209565
58649,2068,7,2,9,Q,29.0426403500035
76409,2068,6,0,6,S,29.11691623717337
138456,2067,4,2,6,J,29.01137351871302
65726,2067,5,1,6,P,28.93578141922173
114046,2068,6,2,8,E,28.65310833748954
149333,2068,7,0,7,J,28.899614010578656
78260,2067,4,2,6,P,29.00259134580736
133324,2067,2,1,3,K,29.44992366192924
72702,2067,5,2,7,E,29.23716553507284
83593,2068,3,3,6,N,29.025573331909516
64972,2068,4,0,4,C,28.933541211172106
167522,2068,4,1,5,M,29.00735340400845
139578,2068,5,1,6,Q,28.75050863804068
81393,2067,2,0,2,D,29.31511489125693
94130,2067,2,2,4,N,29.78114997985019
87263,2068,8,4,12,L,29.020830934718656
88280,2067,5,2,7,E,29.163045271235585
67205,2068,7,0,7,J,29.11891109810317
159648,2068,4,3,7,J,28.82417276391562
176735,2068,2,3,5,Q,28.731517173491227
158726,2067,5,1,6,N,29.62574327900592
106250,2068,1,1,2,S,28.85925611369478
55124,2067,6,1,7,E,29.425563437696823
162524,2068,4,2,6,N,29.045054119862364
44344,2068,2,1,3,A,29.100289140643927
111247,2068,5,2,7,E,29.32312532807672
143756,2068,6,1,7,E,28.71520515732645
109342,2068,5,1,6,J,28.830390697183923
26477,2067,5,1,6,E,28.946046424047605
142404,2068,5,2,7,M,28.806540102804576
158651,2068,5,3,8,N,28.89221989499158
17528,2068,2,2,4,E,28.861837610414995
23401,2067,6,1,7,J,29.12193192203718
89511,2067,2,1,3,C,29.08138448669954
101681,2067,7,0,7,J,29.28439241138515
105170,2068,3,1,4,N,28.92031399059512
111236,2068,2,1,3,K,29.127902580515748
91807,2067,3,2,5,N,29.09499673261273
149136,2068,6,0,6,M,28.79732906841963
169471,2067,5,2,7,N,29.101654218209188
182990,2068,8,2,10,M,29.00949778386426
103837,2068,5,2,7,P,29.09305508947836
74117,2067,9,2,11,P,29.192925979982565
144400,2067,4,3,7,A,29.07395763345688
170165,2067,14,0,14,N,29.27413140095427
118294,2068,3,0,3,N,28.79011658549853
56292,2067,6,2,8,E,29.40291228009289
60698,2067,2,0,2,J,29.26204395694085
70539,2067,2,2,4,E,29.23391411910957
109120,2068,5,2,7,J,28.957465876110163
169430,2067,5,0,5,D,29.116798141803997
140476,2068,5,1,6,M,28.855567973625384
17216,2067,6,0,6,H,29.04046838409944
59951,2068,9,1,10,D,28.906483344593745
70833,2068,3,0,3,E,28.84354889061944
62529,2067,4,2,6,N,29.14590528392441
16820,2068,3,0,3,J,28.793951909006637
121446,2068,4,2,6,J,29.05138550487742
156895,2067,4,2,6,M,29.2569573438508
50390,2068,8,2,10,P,29.01331975680831
124782,2067,3,0,3,A,28.968806158762217
77586,2067,8,1,9,E,29.38556473743609
165564,2068,4,1,5,P,28.824290421474103
122230,2067,1,5,6,P,29.14740184974519
61803,2068,5,4,9,E,28.830327886328508
124568,2068,3,0,3,E,28.884548736106986
62338,2067,4,0,4,P,29.129565579700213
16300,2068,5,1,6,Q,28.77226073349035
59139,2068,3,1,4,Q,29.092879911739445
103093,2067,6,1,7,Q,29.08014553317124
120072,2067,3,0,3,P,28.870920357748084
141978,2067,7,0,7,M,29.063277173291297
163553,2068,3,0,3,N,28.8782589787264
166290,2068,4,1,5,N,28.560571326822483
16849,2068,4,1,5,P,28.99037022491437
138275,2068,5,2,7,Q,28.65183271672312
144396,2067,4,1,5,K,29.50825106041548
82452,2067,5,1,6,N,29.33270369955341
180503,2067,5,2,7,E,29.064665433722144
148725,2068,3,2,5,N,28.7907937274148
128298,2068,5,3,8,M,29.066440028702647
178195,2067,7,2,9,P,28.902832432383004
183408,2068,2,2,4,A,28.629191775071632
95868,2068,2,4,6,E,28.89369618653003
66261,2068,8,2,10,P,28.776269912803624
42050,2068,7,2,9,Q,28.75860841943818
170854,2067,4,2,6,P,29.13750227033177
107628,2067,4,2,6,P,29.209843456820657
117735,2067,3,1,4,E,28.88032908070065
83889,2067,4,2,6,D,29.11489326421936
60470,2068,3,1,4,Q,28.839935502243016
145581,2068,6,0,6,E,28.86533873141211
140198,2067,4,4,8,E,29.23233722197965
47236,2068,5,1,6,N,28.73836602528627
78715,2068,3,0,3,P,28.861540302677597
144802,2067,2,3,5,D,28.900004028283167
105250,2068,1,1,2,E,28.76935469919526
15851,2067,13,2,15,A,29.116762928662475
107987,2068,4,1,5,Q,28.904296614614665
74804,2067,5,2,7,L,29.39218594001943
32793,2067,2,1,3,J,29.577704192350858
94968,2068,2,2,4,E,28.73556712651437
117566,2068,7,1,8,E,28.797974836990647
59422,2068,2,1,3,J,28.672851482649804
36399,2067,3,1,4,Q,29.14783426922215
119827,2067,3,2,5,N,29.503312391618447
62489,2067,6,2,8,S,29.27820617049128
163529,2067,11,1,12,E,28.78333078001258
60544,2068,7,0,7,E,28.66143577306332
119937,2068,2,2,4,E,28.69782302535691
118427,2067,3,0,3,Q,29.27488807189337
46092,2068,2,1,3,S,28.712795602302958
147677,2068,6,2,8,N,28.848712790223644
172832,2068,6,2,8,N,28.906197502638804
138875,2067,3,2,5,S,29.67631239427209
92132,2067,6,2,8,M,29.266878048487936
112240,2068,7,2,9,Q,29.104753338881327
17301,2068,6,2,8,P,28.972711212204597
106997,2067,7,1,8,N,29.22191069071033
60216,2067,4,0,4,Q,28.96582208013409
56990,2067,5,1,6,M,29.29088476693114
96378,2067,6,0,6,J,29.18557891897346
26678,2068,0,4,4,D,28.780003951723103
106585,2067,1,4,5,Q,28.97127050051223
125718,2067,7,1,8,J,28.981134827042165
76920,2068,5,1,6,N,28.884132525241068
122897,2067,6,1,7,E,28.964733615555225
182284,2067,6,1,7,E,29.098231330905005
171740,2068,7,0,7,Q,29.009955806033464
72298,2067,3,1,4,K,29.367490793684087
128030,2067,5,1,6,M,29.0669747945282
117270,2068,7,3,10,A,28.66123639080992
63354,2067,7,3,10,I,29.571430301414573
27587,2067,2,1,3,N,28.89606286765727
138974,2067,2,0,2,M,29.26764847155824
101636,2067,1,1,2,P,29.217469586800025
97433,2067,4,0,4,J,29.13780260364364
100665,2068,3,1,4,E,29.199882862492053
61534,2067,5,0,5,N,29.20359625250494
92459,2067,3,2,5,N,29.111971877943372
15959,2067,9,1,10,D,29.360925723739108
123674,2068,2,1,3,D,28.69025716910684
157099,2067,4,2,6,Q,28.99137102151609
136152,2068,4,0,4,E,28.621505129078542
175191,2068,3,2,5,R,28.9199690149674
109792,2067,2,2,4,N,29.01744227462285
70474,2068,4,0,4,E,28.92062775968561
17565,2068,5,0,5,D,29.019825894416837
179492,2067,3,2,5,G,29.366246297895465
62843,2067,2,0,2,J,29.2054502461626
26123,2068,9,1,10,E,28.871595556781458
111590,2067,8,2,10,J,29.118532289900195
167737,2067,6,1,7,N,29.38186509819038
66825,2068,2,0,2,A,28.74892561547449
136819,2067,5,2,7,E,28.998377703187742
145438,2068,6,0,6,A,29.019261931344648
113140,2068,6,2,8,N,28.89050864109996
72965,2068,3,3,6,K,28.767612146276992
145292,2068,6,1,7,Q,28.526801014667093
26730,2067,4,0,4,E,29.444147289649084
142421,2068,8,0,8,N,28.47823138501157
102909,2067,11,2,13,D,29.03046191639629
61794,2068,4,0,4,N,28.929236512508712
111179,2068,5,2,7,N,28.702329680671927
174251,2068,3,1,4,Q,28.658044303177206
178749,2068,5,2,7,K,28.5807561021923
112450,2068,6,1,7,P,28.631957686976296
148883,2068,5,1,6,P,29.31580470245467
102778,2067,5,0,5,N,28.95615253594181
71837,2068,5,1,6,J,28.617710837848183
169230,2068,6,1,7,D,28.94306501637285
142364,2067,8,0,8,P,29.64329960028311
164616,2067,3,0,3,E,29.138841167250938
48983,2067,8,0,8,H,29.145681057085884
59644,2067,6,1,7,Q,29.112533979566784
141824,2068,4,1,5,M,28.74806157840361
98546,2067,3,2,5,J,29.305870049043083
96491,2068,16,0,16,M,28.913619388920537
157516,2067,3,2,5,A,29.417252418167685
119415,2067,9,2,11,E,28.93313510555248
86896,2067,6,0,6,E,29.01775102037289
105964,2068,6,2,8,J,28.68597034192397
55491,2068,4,0,4,K,28.90179257534257
19549,2067,6,1,7,J,29.106598780365143
180854,2067,2,2,4,C,29.49406297649302
36534,2068,5,2,7,J,29.062526136249613
162685,2068,6,2,8,Q,28.430787826872077
136337,2067,3,2,5,P,29.27570755948372
144480,2067,3,3,6,S,29.32581431873084
161802,2067,5,0,5,E,29.117781542781174
124369,2068,3,0,3,D,29.11747626129967
37998,2067,3,1,4,D,28.883526618484705
96546,2067,2,0,2,E,29.190899875005165
94742,2067,9,0,9,Q,29.14537797616446
98726,2068,5,2,7,P,28.84913611098219
157604,2068,6,2,8,E,28.5750789989951
161223,2068,7,1,8,E,28.797604356950323
164597,2067,6,1,7,H,29.30296353168181
131854,2067,4,0,4,J,29.067772769655527
26252,2068,8,0,8,M,28.762484874193373
48858,2067,7,2,9,H,28.90993954053047
131804,2067,5,2,7,E,29.11653145092261
94395,2067,3,2,5,Q,29.167635670746797
132424,2068,1,4,5,M,28.758375806148997
106229,2068,6,0,6,J,28.733648824292835
74379,2068,4,2,6,D,28.83120065062958
120677,2067,4,1,5,E,28.949427228835603
16032,2068,7,1,8,J,29.02017422032777
45847,2068,6,0,6,J,28.93895930258931
41188,2068,6,3,9,D,28.85272764870505
122170,2068,5,3,8,Q,29.07342268705808
50344,2068,2,1,3,E,28.86034558120321
120861,2068,2,1,3,N,29.10407773216752
61783,2067,4,3,7,Q,29.419435338891315
114296,2067,5,1,6,M,29.28383153974391
47349,2068,6,2,8,J,29.176262337823584
135078,2067,8,2,10,A,28.970216814818617
66228,2068,7,1,8,E,28.551970739442066
46520,2068,1,2,3,N,28.814081519892053
41815,2068,2,2,4,N,29.16918952814495
19225,2068,2,0,2,D,28.84741985583929
63939,2067,3,0,3,Q,29.189636852749214
88798,2068,4,3,7,J,28.86648243242097
180042,2068,7,2,9,J,28.797907635554047
65473,2068,6,1,7,N,29.102020011408214
102268,2067,5,1,6,S,29.14115324342704
42446,2068,3,1,4,N,29.125298032101785
62776,2067,5,0,5,R,29.415898161831404
132484,2067,6,0,6,N,29.37313662378982
103835,2067,3,2,5,N,29.235855632234337
129597,2067,5,2,7,P,29.503664713189632
45302,2068,5,3,8,Q,28.77794026049913
73149,2067,5,1,6,Q,29.15690424451847
67152,2068,1,2,3,S,28.64745160561052
105211,2068,2,2,4,E,28.75227761469156
45927,2067,4,1,5,E,29.019234775969853
60491,2068,3,1,4,E,28.906534730334027
86394,2067,3,0,3,K,28.97210913855586
107815,2068,4,0,4,P,28.75561817911321
73973,2067,5,1,6,Q,29.523083450944878
123713,2068,4,0,4,P,28.695983480054824
155904,2068,8,0,8,N,28.68079384725994
35511,2068,2,0,2,J,29.23042285302136
21750,2067,2,2,4,D,28.81391718270066
93981,2068,4,1,5,M,28.95031102493788
26976,2068,5,2,7,P,29.06319889650863
90402,2068,6,1,7,E,28.71371625705629
146235,2068,3,0,3,Q,28.59105661008243
141963,2068,5,2,7,M,28.975989688688323
74821,2067,2,0,2,M,29.294871812314035
64249,2067,5,0,5,Q,29.20317421282138
101158,2067,7,2,9,M,28.967607236780847
78768,2068,7,1,8,K,28.379831656395403
157516,2068,4,4,8,A,28.87918280047649
49068,2067,5,2,7,E,29.43263989473332
65559,2068,2,0,2,E,29.195102599153497
104226,2067,5,2,7,J,29.40831247946988
55591,2068,6,0,6,A,28.849532422404465
165598,2068,7,0,7,D,28.80840019597024
26034,2068,6,0,6,E,29.043359047705128
182534,2067,5,1,6,M,28.929036316283597
40878,2067,5,0,5,D,29.22078974386485
123894,2068,6,1,7,E,28.84471857219724
99737,2068,2,1,3,E,28.569042768411155
170937,2067,5,0,5,N,29.2515692517228
73694,2067,7,0,7,P,29.173882880584
84214,2068,6,3,9,I,29.13583094452147
84910,2068,3,2,5,D,28.559850551306816
76547,2068,4,2,6,K,28.94992783223291
159850,2067,3,2,5,E,29.15115358165365
35790,2068,2,0,2,Q,28.88236162138565
63147,2067,4,0,4,H,29.25252849119373
82255,2067,9,1,10,C,29.505710845297845
164409,2067,2,1,3,N,29.030885824004287
160891,2067,6,1,7,P,29.3533596930755
61448,2067,6,0,6,E,29.17473969440043
95784,2067,5,2,7,E,29.15539997602057
17536,2068,6,2,8,P,28.75408985091756
176942,2068,3,1,4,R,28.94725695529404
108626,2067,6,2,8,Q,28.94953980567592
130585,2068,6,2,8,E,29.03980495198473
172258,2068,5,2,7,Q,28.91497951516593
106849,2067,1,2,3,K,29.173090421140973
140725,2068,6,2,8,M,29.08640863237434
17423,2067,6,2,8,P,29.097391459129764
31215,2068,4,1,5,K,28.84972679370939
104933,2067,4,2,6,N,29.2773757972351
110796,2067,3,3,6,N,29.08501820246277
66561,2068,5,2,7,M,28.661961499946216
102315,2067,3,3,6,N,29.19135969564588
131784,2067,3,6,9,A,28.996837176960423
68464,2068,5,2,7,S,28.63760134025993
179880,2068,8,2,10,P,28.655386334362458
114418,2067,7,2,9,J,28.95931354557529
83105,2067,3,1,4,F,29.29428023814765
20584,2067,2,1,3,S,29.12169301498032
96774,2067,2,3,5,M,29.396203201368756
88684,2068,4,1,5,M,29.156502512138385
46216,2068,6,1,7,E,28.83476458644273
116799,2067,6,2,8,E,29.095311254427514
54302,2067,5,2,7,E,29.18614453267357
119329,2067,5,2,7,P,29.351688673272736
148002,2067,4,1,5,A,29.15585548208914
143610,2067,4,2,6,E,29.247329830494223
34266,2067,4,0,4,K,29.4813885179864
20795,2067,1,3,4,P,29.339686813447845
163150,2067,5,1,6,J,29.032951563243653
38829,2067,5,2,7,Q,29.708510342017853
19339,2067,6,1,7,K,29.60044448840033
72555,2068,2,2,4,N,28.650545847169827
120049,2067,5,1,6,E,29.283807547381823
79298,2068,3,2,5,P,29.076755889293363
163039,2068,4,1,5,N,28.99463950477992
167185,2068,6,3,9,S,28.72106710121097
130292,2067,7,2,9,E,28.87729580741672
170281,2068,7,2,9,N,28.656846098310574
156754,2067,4,2,6,N,29.038487863998704
83717,2067,6,2,8,M,29.40228483075685
94947,2068,7,1,8,N,29.26536503942099
101807,2068,6,2,8,A,29.000853344651645
133879,2068,2,1,3,K,28.742717210067443
84025,2067,5,1,6,D,29.124071481270363
117111,2068,6,0,6,E,28.68195196350265
146925,2068,5,3,8,M,28.88408342170434
173071,2068,10,1,11,E,28.892610277476987
146511,2067,1,2,3,M,29.01421665734865
180571,2067,3,0,3,K,29.24675538578051
166413,2067,6,2,8,K,29.3676330103916
44294,2067,5,3,8,D,28.99087934163161
109296,2067,5,0,5,E,29.443979497561944
45030,2068,4,2,6,N,28.69578091759861
71338,2067,4,0,4,E,29.19479793372344
38241,2067,4,2,6,N,29.45214689992503
99341,2068,5,1,6,Q,28.69204363224004
165349,2067,4,1,5,E,28.98147115904796
158796,2067,5,1,6,S,29.38426587936257
143029,2067,4,1,5,Q,29.31640648920006
114167,2068,8,1,9,J,28.91958454753886
141976,2068,12,3,15,Q,29.29417989941981
142311,2068,3,0,3,K,28.96004088562385
107724,2068,5,2,7,E,28.77013034639944
58976,2068,4,1,5,N,29.017628671514263
146276,2068,2,3,5,P,28.767969099104235
180790,2068,6,0,6,N,28.90065371545949
46336,2067,4,0,4,E,29.27853570704372
30037,2068,3,1,4,D,28.56393909402367
42435,2068,2,2,4,K,28.943083113535984
120020,2067,2,2,4,P,29.35078528422206
49756,2067,6,4,10,Q,29.25024720055411
108981,2067,4,0,4,N,29.276353379807816
181623,2067,6,1,7,N,29.299571955624277
60832,2067,6,0,6,P,29.0793848852126
16809,2068,8,2,10,E,28.669692835328355
44301,2067,8,3,11,A,29.21325583118513
104868,2067,3,2,5,P,28.963464540835208
55354,2067,2,3,5,E,29.190312207794893
51367,2067,2,3,5,N,29.203732777141507
56224,2067,4,1,5,N,29.32137541851039
171135,2068,6,0,6,D,28.79958237046453
106256,2067,6,1,7,K,29.397001159037075
93072,2068,3,0,3,N,28.901757405693907
118598,2068,12,2,14,E,29.02223984925782
71746,2068,2,0,2,Q,29.008938446091165
16839,2068,5,2,7,M,28.78989518940745
62790,2068,1,1,2,D,28.519864616333702
32914,2068,3,2,5,E,28.644493817605984
121495,2068,5,3,8,P,28.6818560854125
114141,2067,5,0,5,N,29.022355253556675
141960,2067,7,1,8,J,29.153389807696293
135459,2067,7,1,8,M,29.28488055576441
19561,2068,7,1,8,D,28.96860918566701
27923,2068,10,2,12,P,28.9241877373056
182913,2068,5,0,5,J,29.15500891364782
175018,2067,4,4,8,D,29.29130537162426
181758,2068,6,1,7,J,28.976565967958727
84411,2068,10,2,12,A,28.61982315120856
103093,2068,5,0,5,Q,28.943985070010065
40940,2067,4,1,5,K,29.13848125491405
94935,2068,4,1,5,E,28.707358562014484
116203,2068,5,1,6,Q,28.99592522855846
68176,2068,6,0,6,N,28.942685939029147
67760,2067,3,2,5,M,29.19202964851268
177244,2067,8,0,8,E,29.103445123363723
46071,2067,3,1,4,I,29.01807972728045
44544,2068,5,0,5,N,28.553758954199804
103080,2067,8,1,9,E,29.509306879671858
65555,2067,3,0,3,P,29.106977147275472
137167,2068,5,3,8,M,29.155470424837382
89966,2068,6,0,6,Q,28.71189376821537
84906,2067,7,0,7,F,29.231938197352548
82343,2068,4,1,5,Q,29.095301707907733
61668,2067,2,2,4,D,29.44727482774591
65474,2068,6,0,6,A,28.865025182132925
24214,2067,2,3,5,E,28.914424954332983
92760,2068,7,1,8,D,28.772013445259542
94441,2068,3,0,3,Q,28.89065641318765
147177,2067,5,1,6,Q,28.995087354437597
81798,2068,6,3,9,E,28.7396652684584
182822,2067,8,0,8,M,28.970682732478195
172523,2068,5,2,7,D,28.74819713335425
104284,2068,5,2,7,E,29.256041456740164
101169,2067,2,1,3,J,29.10576649751556
135740,2068,2,2,4,P,28.752307554707563
52046,2067,4,2,6,J,28.87080359692854
61753,2067,3,0,3,D,29.188302227479895
72271,2068,3,1,4,J,28.74317368254609
147746,2067,7,0,7,E,28.92519581937616
101659,2068,6,1,7,S,28.623736358260324
94856,2067,6,1,7,D,29.1036987099498
83730,2068,6,2,8,D,28.586445731831866
71004,2068,4,0,4,K,28.64031111448761
105109,2067,4,3,7,M,29.41351246127585
74971,2068,4,0,4,E,28.82743998732632
77314,2068,7,2,9,I,28.87939379408399
98478,2068,2,3,5,E,28.989125831311384
117509,2067,5,1,6,P,29.52536744123265
18423,2068,6,1,7,N,28.493636730883136
58898,2068,2,2,4,P,28.88872186665583
148965,2068,3,3,6,M,28.8244652199501
125391,2068,5,1,6,M,28.89961811622511
167277,2067,7,1,8,M,29.296016325174005
90279,2068,4,3,7,P,28.894310921394645
143063,2067,5,1,6,E,29.55594292774133
145946,2068,3,3,6,S,28.98799196583628
49376,2067,5,2,7,D,29.330931080158425
138296,2068,8,2,10,N,28.886407090679697
16059,2068,2,1,3,Q,29.029500164144373
165863,2068,3,1,4,M,29.21395290702352
17486,2068,6,2,8,N,29.135187019591903
167592,2068,4,2,6,N,28.712891132516464
58759,2068,5,0,5,E,28.83559553434484
121643,2067,4,1,5,E,28.96459407933906
96262,2067,10,4,14,E,29.111843151750158
28993,2067,6,1,7,E,29.07242916684511
128863,2067,4,0,4,D,29.240151655017247
66257,2067,5,1,6,E,29.238548770303183
112991,2067,3,2,5,E,29.24457062180953
77862,2067,3,1,4,P,29.05650264094517
182622,2067,4,2,6,G,29.15970916565561
69144,2068,4,1,5,Q,29.055923814074173
114090,2068,2,0,2,J,28.814378348915337
157512,2067,2,3,5,M,29.41603698088685
158811,2068,7,0,7,S,29.009969582497835
113753,2068,7,0,7,P,29.057248615430268
132484,2068,4,0,4,N,28.3942142545336
96311,2067,5,0,5,J,29.10243125866381
62264,2068,6,1,7,P,28.78532321795656
108478,2068,5,1,6,N,28.68887775934144
117329,2068,6,1,7,D,28.958167420202308
83514,2068,7,1,8,J,28.906915499665608
41704,2068,7,2,9,M,28.784823315848943
128683,2068,2,2,4,D,29.228613738169592
60832,2068,5,2,7,P,28.93401528943232
128558,2068,3,0,3,R,28.819517431176763
24894,2067,8,1,9,J,29.100501802544155
84343,2068,4,2,6,H,28.866033194863213
160139,2068,5,0,5,A,28.93080043498357
20150,2068,4,3,7,J,28.99619470354779
52577,2068,4,0,4,P,28.808279224660257
176274,2068,6,0,6,P,28.57016683223
112071,2068,3,1,4,E,29.14428574923291
106850,2068,5,2,7,K,28.89169951133729
23535,2068,3,2,5,E,28.98294097859018
97998,2068,3,0,3,N,29.01187563535639
111254,2068,5,1,6,J,29.057397482316446
147683,2067,6,0,6,J,29.16297679436703
140412,2068,7,0,7,S,28.612750143138832
180376,2068,4,1,5,M,28.59939361354165
182913,2067,7,0,7,J,29.023440056899656
104244,2067,6,2,8,N,29.0059857739122
66552,2068,3,0,3,K,29.195484152529488
20866,2068,3,2,5,P,29.125540281937017
119436,2067,3,3,6,F,29.05980234362762
100155,2068,2,1,3,Q,28.65115310313199
120883,2068,2,2,4,M,28.885828402089235
172771,2068,4,2,6,N,28.95560507830204
146071,2067,4,3,7,P,29.235676544204708
32168,2068,6,2,8,E,28.57328103118182
117452,2068,5,1,6,P,28.71802524966757
35307,2067,5,1,6,H,29.396317732715755
41077,2068,4,2,6,K,29.13444734760955
59257,2067,7,5,12,N,29.21842498055821
82444,2068,1,4,5,S,28.7537074999358
88684,2067,3,1,4,M,29.29492586929365
85707,2067,3,1,4,E,29.37685385156817
142171,2068,9,0,9,A,28.837638324691845
76315,2068,2,2,4,D,28.762801236447974
163505,2067,6,1,7,M,29.166907161298266
144468,2067,5,3,8,N,29.807313846542137
182647,2067,5,1,6,D,28.864255810674663
27233,2068,3,2,5,D,28.863058414610407
129475,2068,4,2,6,N,28.979680379100493
141937,2068,6,2,8,P,29.02327459287882
75622,2067,4,2,6,K,29.22362497969431
99781,2068,7,1,8,A,29.29983713009989
125281,2067,4,1,5,M,29.30422359859549
20447,2068,4,0,4,Q,28.9290219877127
38795,2067,7,2,9,R,29.270168369668102
87931,2067,6,1,7,H,29.214265601133096
133002,2068,2,1,3,K,29.12489856608505
93837,2067,4,5,9,N,28.692656897310428
25594,2067,7,2,9,Q,29.37603890719247
176213,2068,2,1,3,D,28.99909984147127
150116,2068,7,0,7,S,28.80796307475781
111991,2067,5,2,7,J,28.9707215151812
174616,2068,2,0,2,N,28.775267076797864
33366,2067,6,0,6,N,29.12150906560984
137776,2068,2,3,5,N,28.901697427321167
71171,2068,4,0,4,K,28.52931160685362
170099,2067,5,3,8,N,29.387763444074988
143026,2068,2,0,2,M,29.10863884854577
22068,2067,4,1,5,J,29.21981335119804
167565,2068,4,2,6,K,28.792277028468984
146310,2067,6,3,9,E,29.322486997064846
118998,2067,3,3,6,N,28.97341250407525
174840,2068,9,1,10,J,28.955588281447454
110796,2068,2,2,4,N,28.837662060295045
47046,2067,8,3,11,Q,29.27888664292818
31554,2068,4,2,6,L,28.988781164453265
15972,2068,6,1,7,K,28.852489693516656
117974,2067,6,1,7,E,29.32533612132358
179865,2068,7,0,7,P,29.26572450323224
77203,2068,4,2,6,F,28.54653770110029
165651,2068,4,3,7,M,28.868662276819283
17304,2068,4,2,6,P,29.105087414563567
139429,2067,3,2,5,N,28.94248484173235
173071,2067,7,1,8,E,29.007813131999743
105296,2068,2,0,2,E,29.19706996121432
134398,2068,4,1,5,P,29.088238940865345
109902,2068,6,2,8,E,28.916771550892864
137672,2067,6,1,7,M,28.8822017676922
181881,2068,1,3,4,J,28.929011325917795
62089,2067,4,0,4,E,29.05542972115728
170302,2068,39,11,50,N,28.705889214074293
103551,2068,7,1,8,S,28.969342202263
94872,2067,3,2,5,A,29.34075196007468
35755,2068,5,2,7,E,28.975850720089333
81341,2067,7,0,7,C,29.04699483790025
69238,2068,3,2,5,E,28.94736071297027
20789,2068,9,2,11,E,29.20052337857963
42542,2068,7,2,9,C,28.69156292052616
158921,2068,0,3,3,Q,28.79924532764081
73140,2067,7,2,9,A,29.47859747429961
162650,2068,5,3,8,J,28.76920790884236
97736,2068,5,1,6,J,28.91727985280258
180854,2068,3,3,6,C,29.01280034774252
98651,2067,2,1,3,N,29.21368889121184
146775,2067,6,1,7,M,29.372885700373807
145363,2067,6,2,8,M,29.39676227614743
92983,2067,7,2,9,A,29.1213507893654
165890,2068,3,0,3,P,29.08343698258157
81973,2068,3,2,5,E,28.734132053457383
115738,2068,2,2,4,E,28.91788020593721
81340,2067,4,3,7,J,28.828004806784573
63704,2067,3,0,3,P,29.07506329315221
29353,2067,8,2,10,E,29.24039168574758
98107,2068,5,3,8,P,28.61741225865096
36980,2067,5,0,5,D,29.43869467991802
87007,2068,3,1,4,C,28.802566331527817
67802,2067,3,3,6,P,29.60872484408834
150382,2068,7,0,7,K,28.744639965858696
114097,2067,4,3,7,E,28.982686726318025
174503,2068,4,0,4,Q,28.981777158256183
62580,2068,4,2,6,D,29.134574545092555
103946,2067,7,2,9,M,29.17539381029161
121721,2067,2,2,4,P,29.30306340644825
139029,2068,2,2,4,N,28.89910889851805
83188,2067,4,3,7,I,29.29454180841151
175111,2067,6,1,7,E,29.4671413508752
138134,2067,6,0,6,P,29.37302575361341
110311,2068,3,2,5,P,28.632302797600016
75282,2068,4,1,5,I,28.823318952225453
53217,2067,5,2,7,Q,29.258369402349125
144887,2067,6,1,7,S,29.07374039205573
148494,2067,7,2,9,M,28.98907684314535
138296,2067,3,2,5,N,29.158677245503377
63709,2067,5,1,6,S,29.533359190315043
89895,2068,3,2,5,S,28.899027618182927
95999,2068,1,2,3,Q,28.92446355640189
146342,2067,3,2,5,S,29.159116089497285
169473,2068,5,2,7,D,29.03854130614604
78363,2068,6,1,7,E,28.686410561204696
114815,2068,4,1,5,P,28.80801029346872
56651,2067,6,0,6,Q,29.289507738170173
117485,2067,3,0,3,P,28.82028814821928
148062,2067,3,2,5,M,29.15569930736149
99368,2068,4,0,4,E,28.73294996262972
111389,2068,2,0,2,P,29.068373788552016
59819,2068,2,2,4,D,28.915356079651144
167156,2068,5,2,7,N,29.04004868268264
92057,2068,3,2,5,E,28.783921599606145
47565,2067,3,1,4,Q,29.131118462971283
145353,2068,6,1,7,M,28.771171053686647
51160,2067,5,0,5,A,29.32601610953521
46216,2067,5,3,8,E,29.32149857050002
81400,2068,7,1,8,D,28.82400104071249
88922,2067,3,2,5,M,29.1021097992882
83034,2068,4,0,4,J,28.802287562794493
177421,2068,1,3,4,I,29.021330347532142
78448,2068,5,1,6,K,28.968491783083174
44956,2068,5,0,5,D,28.797582077665925
71650,2067,7,1,8,E,29.432769667759636
181413,2068,8,2,10,Q,29.17666935885238
31791,2068,3,2,5,N,28.746303387441348
158198,2068,5,2,7,P,28.84576525560003
166619,2068,6,3,9,I,28.884036682699055
84302,2068,5,2,7,Q,28.89173520405711
169298,2067,3,1,4,D,29.38148812565941
22400,2068,3,0,3,M,29.1217362161437
109485,2068,1,1,2,E,29.038719373255308
41158,2067,4,0,4,E,29.38349404076832
144526,2067,5,0,5,M,29.030253284820887
76874,2068,7,0,7,Q,28.913214716559608
145198,2068,6,0,6,E,28.97208141449868
134291,2068,7,2,9,E,29.08811857069542
143610,2068,4,0,4,E,28.94094565235471
156392,2067,2,0,2,Q,29.14562931196769
103517,2068,5,1,6,D,28.94358521872088
36726,2068,2,5,7,E,28.988366876836967
42644,2068,4,0,4,E,28.934250882615075
123819,2068,8,3,11,K,28.96592152144385
162573,2067,5,0,5,E,29.02816793415797
121509,2068,5,2,7,E,28.97986012381707
26625,2068,4,0,4,Q,28.67470569283596
53254,2068,4,1,5,N,28.957116568198217
161549,2068,1,1,2,M,28.890849323316665
109201,2067,4,0,4,N,29.05310469458451
104558,2068,7,0,7,P,28.898296171753184
114886,2068,4,2,6,M,28.858354283154732
63155,2067,2,0,2,E,29.36259592243362
32247,2068,6,0,6,J,28.738081336320235
141961,2068,3,2,5,A,28.910616951941268
96105,2067,3,0,3,Q,29.18392987990508
21350,2067,5,2,7,P,29.084796713984733
56431,2068,3,3,6,S,28.851221305434507
100599,2068,4,3,7,N,28.979223000096106
52222,2067,3,0,3,Q,29.177195857126613
117163,2068,3,2,5,Q,29.22118982118988
39943,2068,2,2,4,M,28.81659393493342
136768,2068,3,2,5,J,28.973133247449255
103687,2067,5,2,7,N,29.05975488596784
140323,2068,2,0,2,K,28.789781052788403
114308,2068,6,1,7,M,28.65854583676406
31453,2067,4,3,7,E,29.014610422277357
160907,2067,2,1,3,Q,29.045721689423356
21214,2067,6,1,7,C,29.35087849949027
72368,2067,5,0,5,J,28.86867989428172
55902,2068,5,3,8,N,29.026839994964764
27943,2068,5,0,5,K,28.95302529695265
68479,2067,2,0,2,M,29.143065680242398
103517,2067,5,2,7,D,29.430688833248595
32335,2068,6,1,7,E,28.992020717646167
36085,2068,6,3,9,D,28.739055376654317
24298,2067,6,2,8,E,29.29611816082581
36195,2067,3,2,5,J,29.307850972630284
25253,2068,4,0,4,J,28.651374693512565
95233,2068,6,1,7,N,28.669083785540074
49341,2067,4,0,4,E,29.27027305200499
63849,2067,3,2,5,N,29.31816547255753
63067,2067,9,7,16,Q,29.38035021251402
93125,2067,7,1,8,J,29.297993520968635
126342,2068,2,0,2,S,29.12514899070362
22811,2068,7,2,9,M,29.086539168336497
82715,2068,6,1,7,Q,28.613934456396173
73494,2067,5,2,7,M,29.376164513584936
131601,2067,5,0,5,N,29.268038350097186
56763,2067,4,0,4,M,29.12069077109896
87641,2067,3,1,4,N,28.91956687236606
33818,2067,5,1,6,E,29.237617775667005
55463,2068,6,1,7,P,28.813760680063996
157980,2068,9,2,11,E,28.909890585796862
45418,2068,4,2,6,M,29.01194691907639
114658,2068,3,3,6,E,28.736950622580185
133281,2067,6,1,7,K,28.889579763350326
94750,2068,2,3,5,J,28.64125467386169
48967,2067,5,2,7,P,29.016214211832267
64889,2068,10,5,15,E,29.00611660937272
135743,2067,2,0,2,N,29.474005464796807
28156,2067,6,1,7,H,29.086543033899808
36915,2067,6,1,7,E,29.16114593678814
140969,2068,6,1,7,E,29.02051914453813
35464,2067,2,0,2,A,28.94506053459473
167582,2067,3,3,6,Q,29.47512565778629
94701,2068,5,2,7,N,28.80923973368217
66435,2068,6,2,8,E,28.73903384838204
77442,2068,5,1,6,E,28.960361122043462
122668,2067,5,3,8,N,29.048558578888944
156105,2067,5,3,8,E,29.222091353231143
58851,2068,2,2,4,E,28.893249959161
147328,2068,2,3,5,J,28.80948493274273
181881,2067,3,2,5,J,29.28614777964575
144468,2068,4,3,7,N,29.00109414291782
68885,2068,3,0,3,J,28.857626290864488
48927,2068,2,4,6,J,29.15562084498414
69490,2068,3,2,5,N,28.655249733011185
180383,2068,7,0,7,N,28.817561029110355
23813,2068,5,1,6,E,29.04564573879016
116861,2068,4,2,6,J,28.728193169317365
60047,2067,6,1,7,D,29.494823492698885
160296,2068,3,0,3,E,28.682219159259358
37131,2068,5,1,6,E,28.950689594007848
38935,2068,1,4,5,J,28.782522592875825
110189,2067,3,2,5,K,29.306317961014585
21165,2067,2,2,4,E,29.10719827721885
169691,2067,2,0,2,D,29.321873946215213
19445,2068,7,1,8,N,28.98663661095998
76655,2067,3,2,5,M,29.27764144623385
69233,2067,6,2,8,P,29.40776468919657
64609,2068,2,1,3,S,28.992239834986563
73877,2067,7,2,9,E,29.28131435397659
100535,2068,5,2,7,N,28.68816920177482
111822,2067,5,0,5,E,29.110409129040832
24046,2067,6,0,6,N,29.28494702936626
37132,2067,3,3,6,E,29.198099240538813
65508,2068,4,1,5,J,29.015876678179957
67909,2067,10,2,12,C,28.93642267015858
94961,2068,4,0,4,N,28.86825448541727
19176,2068,5,1,6,N,28.722664095360773
130084,2068,6,2,8,E,28.951094451184066
17141,2067,4,0,4,E,29.28402504709321
145352,2068,8,0,8,M,28.55648555502573
129449,2068,5,3,8,M,28.89622117902641
174443,2067,3,2,5,N,29.16516774358926
21350,2068,4,1,5,P,28.84544656984263
137488,2068,4,1,5,K,28.85981278836685
114880,2067,6,1,7,A,29.181321462697607
55386,2067,6,2,8,J,29.15051277458767
113971,2067,4,2,6,N,29.105698739013164
98422,2068,5,0,5,Q,28.711368831371704
132781,2068,6,1,7,P,29.17035030530757
26562,2068,7,0,7,E,29.020520967295827
62694,2068,5,1,6,E,28.94244004724064
112589,2068,6,1,7,M,28.66504214903233
132844,2067,5,1,6,J,29.077345690493107
124176,2068,3,1,4,M,28.845417179500917
76058,2067,6,3,9,F,28.842334328847787
54011,2067,2,0,2,Q,29.04729258173022
160925,2067,7,0,7,N,29.31901434804893
170083,2068,2,0,2,D,29.32556286578229
116223,2067,3,3,6,P,28.813056990948933
173818,2068,5,3,8,J,29.09452228521269
116218,2068,4,2,6,P,28.957797068292003
38478,2067,5,1,6,P,29.269695115092716
66831,2068,4,1,5,P,29.086022361731004
17443,2067,5,2,7,P,29.48234547625169
44333,2067,7,1,8,A,29.097543162494954
95821,2068,2,2,4,E,28.76767331212637
157956,2067,7,0,7,N,29.42643544608726
148782,2068,4,4,8,M,28.651841253312487
125331,2067,6,0,6,E,29.1379578485654
38901,2067,12,1,13,H,29.33404724268385
95512,2068,3,3,6,Q,28.768856477376044
16145,2068,9,1,10,P,29.111492172599217
178983,2067,6,1,7,N,29.200638256907823
123407,2067,5,4,9,E,29.165559324234557
133290,2068,1,2,3,S,28.973127006405328
108668,2067,5,2,7,K,29.134400987123424
90072,2067,5,2,7,J,28.965197563102
112969,2067,3,1,4,J,29.407157265816856
139270,2067,6,1,7,P,29.032704115007405
15880,2068,5,1,6,D,28.834677506891147
68113,2068,5,1,6,D,29.019201572605866
60125,2067,3,1,4,D,29.464569850283496
179337,2067,2,2,4,Q,29.34890405728236
31577,2068,3,2,5,D,28.680019507025563
65070,2068,1,2,3,D,28.707689050458256
90321,2068,5,1,6,M,28.7210462849896
21417,2068,0,5,5,J,28.90637936109698
28016,2068,10,2,12,J,28.996642104081964
120020,2068,6,1,7,P,28.706822943952066
181310,2068,8,4,12,D,29.006609773152327
132705,2067,6,2,8,N,29.18763161909014
82475,2068,7,0,7,Q,28.908841316869825
31298,2067,2,2,4,M,29.42471687624754
92068,2068,5,3,8,N,28.595646881308184
69710,2067,7,1,8,D,29.01308839484856
38512,2067,4,2,6,I,29.24803633105806
73096,2067,2,1,3,D,29.105855595842865
39257,2067,2,1,3,K,29.355697733936594
138280,2067,4,1,5,K,29.309099679871583
162787,2068,4,1,5,E,28.90968436477474
18822,2067,7,0,7,E,29.394578427149245
132817,2068,7,0,7,P,28.737630730811254
164930,2068,2,1,3,Q,28.84172457448058
109281,2067,6,1,7,N,29.186084850050964
53148,2067,3,0,3,M,29.222810251837096
176902,2067,2,0,2,J,29.2591912953648
118258,2068,5,1,6,Q,28.86356463945739
77366,2067,3,1,4,J,29.19479610120784
63570,2067,7,2,9,E,29.454555721785024
104511,2068,13,2,15,N,29.03231891015103
22773,2068,6,1,7,M,28.65210827004228
157593,2067,1,2,3,N,29.19568121562632
179327,2068,5,0,5,M,28.809389805021684
182748,2068,7,0,7,M,28.71852643886196
57104,2068,3,3,6,M,28.666735828890545
147185,2068,4,1,5,M,29.132633496318117
109428,2067,2,1,3,N,28.940581405170672
164517,2068,3,2,5,D,28.79902615119205
90578,2067,5,3,8,M,29.166298606953813
84950,2067,5,1,6,G,29.19286690380946
105471,2068,6,1,7,N,28.963823314355963
91764,2067,4,3,7,J,29.13370519113877
128711,2068,5,1,6,E,28.653271042418567
77457,2068,5,3,8,Q,29.28868567202545
131227,2068,1,3,4,M,28.73838604416675
170627,2068,4,0,4,E,29.26327781772129
151483,2068,5,1,6,M,29.21167842917833
127598,2068,6,0,6,I,28.626509980683096
78825,2068,1,4,5,M,28.84449846153768
145856,2068,3,3,6,Q,28.83657088625769
117260,2068,6,0,6,Q,28.70507228554238
142716,2068,3,2,5,M,28.66853260908695
148935,2068,7,1,8,M,28.84174063390264
125498,2067,8,3,11,P,29.12989498744285
155904,2067,10,0,10,N,29.51963002741463
28806,2067,3,0,3,E,29.14404015471664
47343,2067,9,2,11,J,29.098104488891163
139421,2067,2,1,3,N,29.15197114984984
42247,2068,2,1,3,M,29.046308374100583
113137,2068,5,0,5,D,28.78405538470297
52072,2067,5,2,7,P,29.26539741642654
148835,2067,4,0,4,Q,29.235208602967724
127757,2068,5,1,6,S,28.926072535083925
41674,2068,5,2,7,K,28.630387554743837
147147,2068,5,1,6,M,29.101352621828568
49341,2068,3,2,5,E,28.90873411148161
29893,2067,3,2,5,E,29.19763716139833
135097,2068,4,0,4,N,28.60563605809412
69290,2067,6,0,6,S,29.29280198559853
94217,2067,4,2,6,E,29.103924629973704
111978,2068,6,1,7,N,28.769187920793904
170211,2067,1,2,3,D,29.269935272407885
148508,2067,6,0,6,M,29.106592144190422
77559,2068,6,1,7,D,28.754952414731317
64065,2068,5,3,8,D,28.823131971592854
37825,2068,8,2,10,J,28.93240093206427
26863,2067,5,2,7,D,29.24220142117074
134678,2067,3,6,9,I,29.21674935957002
17770,2067,5,0,5,E,29.093635621944223
23473,2068,1,3,4,J,28.638968760973015
72743,2067,4,0,4,F,29.061175400586027
172669,2068,6,3,9,A,28.63412526348648
44596,2067,4,2,6,A,29.16893228845525
86036,2068,3,1,4,E,28.61787480259395
61003,2067,2,2,4,M,29.35355753266343
160796,2067,3,1,4,K,29.28585326390748
56616,2067,6,1,7,D,28.818886589461805
157316,2067,2,1,3,N,29.541628933373037
170265,2067,4,1,5,N,29.292453829803723
166503,2068,6,0,6,P,28.95112059650097
97321,2067,4,0,4,N,29.083164686504887
174777,2067,1,2,3,E,29.27692919143345
156284,2067,4,2,6,E,29.326078135372487
105086,2068,3,1,4,E,28.67389441194016
77790,2067,2,0,2,E,29.393213815262094
103915,2067,2,2,4,C,29.109826803700955
54782,2068,3,1,4,M,28.864458317185427
59429,2067,5,2,7,N,29.033785248080854
73885,2067,2,1,3,E,29.10070136218148
141781,2068,7,2,9,J,28.68789219787229
174043,2067,5,1,6,E,29.23188136754413
32387,2067,4,1,5,N,28.988618664184276
21198,2068,3,2,5,P,28.740117754781974
66907,2067,4,1,5,E,28.999751358332134
137932,2068,5,2,7,M,28.69979704046996
28137,2068,7,2,9,N,28.495358214514155
20349,2067,2,0,2,Q,29.22083633504494
169402,2067,2,3,5,A,29.065935087471523
40801,2067,4,2,6,E,29.25748650409555
17915,2067,1,3,4,D,29.242597141534084
41526,2067,4,1,5,P,29.328817243158262
113374,2067,7,1,8,M,29.13457718062624
110919,2068,8,2,10,J,28.93711469892672
182806,2068,5,0,5,P,28.92692526275646
138190,2068,5,2,7,J,28.550288208899246
144474,2068,5,2,7,F,28.82313597008503
114660,2068,4,1,5,J,28.92865143763592
114680,2067,4,0,4,J,29.34290843173047
64390,2067,4,1,5,J,29.16299728677342
174540,2067,6,1,7,E,29.050337820932285
31864,2067,6,0,6,E,29.364533797547832
161006,2067,5,2,7,J,28.99782363160761
166021,2068,3,0,3,N,28.88865038932123
93777,2067,4,1,5,D,29.137212988025503
30293,2068,3,0,3,N,29.283759194021517
18272,2067,5,1,6,D,29.29716546641394
109986,2067,6,1,7,E,29.097298177884987
156284,2068,4,0,4,E,28.903712878700404
16641,2067,4,1,5,Q,29.242085174749874
92228,2068,4,0,4,N,28.88766661006059
101913,2068,6,1,7,P,29.049606914638897
92577,2068,1,1,2,N,29.26222603795533
135064,2067,6,0,6,N,29.437351448276207
134470,2067,2,2,4,P,28.87131425298403
160287,2068,2,0,2,E,29.13538360676316
40512,2068,4,0,4,N,29.03636140489992
88196,2068,3,1,4,H,29.030269010564545
148728,2068,4,0,4,Q,28.39414493034037
94266,2068,3,1,4,M,28.62605325314304
66945,2067,5,4,9,D,29.307804113817983
42375,2068,5,0,5,Q,29.278767798673925
85974,2068,5,2,7,J,29.092418248925348
34096,2068,5,1,6,E,28.75994889085672
97402,2068,3,1,4,N,28.72180225505539
82760,2068,6,0,6,D,28.831239339987636
94925,2068,4,0,4,N,28.629783271947645
21248,2067,4,0,4,Q,29.23238558117603
64026,2068,9,0,9,D,28.535752183465267
28645,2067,3,0,3,K,29.07789261260507
27158,2067,6,0,6,I,29.18708630047033
96605,2067,3,0,3,K,29.22700803646988
170115,2068,5,4,9,N,28.873703811707788
181683,2068,3,1,4,Q,29.20358722689668
50977,2067,5,0,5,N,29.292329317816705
32041,2068,1,1,2,I,28.60181227615149
159811,2067,2,0,2,C,29.568841944546985
102350,2067,5,2,7,N,29.47863360153243
24567,2067,2,0,2,Q,29.35269113591292
173595,2068,4,0,4,J,28.686423178215225
166249,2067,2,0,2,C,29.127723189067734
145541,2068,8,1,9,M,28.58624953386889
48739,2068,6,2,8,E,28.76350762526347
115585,2068,5,2,7,Q,29.13221834648266
151442,2068,6,2,8,P,28.81761297581886
129515,2068,11,5,16,L,29.20133680450505
62332,2067,4,4,8,E,29.311404273776485
41684,2068,2,2,4,M,28.96555787998152
100155,2067,3,2,5,Q,29.72077544685684
87699,2068,1,2,3,E,28.82201300615892
109272,2067,3,1,4,P,29.29098507783802
145623,2067,6,0,6,P,29.135920213377872
66607,2067,5,3,8,D,29.241499492129968
146668,2068,10,1,11,M,28.916373747915927
135843,2068,3,1,4,M,29.2145047472756
142374,2068,2,1,3,P,28.95698047247954
166077,2068,4,1,5,E,29.312778491776346
119470,2068,4,0,4,E,28.712726842412003
63550,2067,5,3,8,E,29.342220909909145
44815,2068,6,2,8,E,29.01133971868248
20252,2068,3,2,5,E,28.69776195662417
103967,2067,6,3,9,L,29.551467459389645
29088,2068,4,2,6,J,28.852570789666142
83441,2067,6,0,6,E,29.280068810703693
38457,2068,5,2,7,M,28.68350721954813
27744,2067,4,2,6,D,29.15470150859041
73479,2067,5,0,5,Q,29.117645390979117
85096,2068,2,0,2,M,28.722086854837496
148538,2068,5,2,7,K,28.9292487001585
24431,2067,5,2,7,D,29.222056412056777
134773,2068,2,3,5,Q,28.8943357753979
46950,2068,2,2,4,E,29.008019265084656
74965,2067,4,1,5,E,29.34962594389632
132495,2067,4,0,4,N,29.131077598353038
157235,2068,8,1,9,A,28.99680604163104
113494,2067,6,0,6,K,29.29614278761396
50726,2068,4,3,7,J,28.77998093905027
134486,2068,4,1,5,D,28.75190947486265
138370,2068,2,2,4,A,28.870497982207876
84514,2067,6,2,8,E,29.02387222648781
41750,2067,4,1,5,J,29.027582603340136
47987,2067,3,1,4,Q,29.33901603902881
35354,2067,10,1,11,E,29.114080781992225
32589,2068,3,1,4,N,29.035562787345068
29496,2067,5,3,8,H,29.06647342251813
146649,2068,7,1,8,J,28.760821153008827
54953,2068,3,0,3,N,28.616396791254125
46507,2068,4,3,7,Q,28.683388232678546
83839,2068,3,0,3,N,28.700300705858915
27791,2068,3,0,3,E,29.15352145565508
31313,2067,3,3,6,N,29.248369384049077
46507,2067,4,2,6,Q,29.0843848162256
62566,2067,3,1,4,E,28.970789650083784
44716,2068,4,4,8,N,29.14946866373881
16002,2068,4,0,4,Q,28.5833433066753
169290,2067,7,0,7,Q,29.32004244532662
18187,2068,2,0,2,M,28.79618102391485
36765,2067,5,3,8,S,29.23549681558841
29468,2067,10,1,11,D,29.24165528891552
149761,2068,4,1,5,J,28.74758512336988
16522,2068,6,1,7,P,28.899549688144784
178294,2067,5,2,7,E,28.99948773764209
26164,2068,3,1,4,P,29.118996024676616
113729,2068,7,1,8,J,28.92740558812558
116451,2068,10,2,12,Q,28.7956008991616
48965,2067,2,2,4,H,29.251904419439168
122074,2067,4,0,4,E,29.358519585640916
38536,2068,7,3,10,J,29.149583627034605
145450,2068,5,0,5,M,28.70395083063565
114749,2067,6,2,8,M,29.218459902425124
174263,2068,2,1,3,J,29.026795976602205
169691,2068,6,0,6,D,28.728836968762344
22305,2068,5,0,5,D,29.014473232117947
34298,2067,4,2,6,E,29.315427976028868
119423,2067,5,1,6,J,29.44685171428424
85647,2067,14,3,17,E,29.30245263206969
72798,2067,3,1,4,M,29.08927513369468
157384,2068,3,4,7,D,28.895408808334302
68532,2067,6,2,8,M,29.06453271607722
70167,2068,4,2,6,E,28.4277272378762
28195,2067,6,1,7,N,28.77347939721204
147379,2067,3,1,4,M,29.193395759587577
101012,2067,3,2,5,N,29.34025693759268
177191,2068,7,0,7,P,29.00964971147281
70364,2067,6,2,8,H,29.684335764352312
166634,2067,2,1,3,M,29.069098091327454
92865,2068,2,2,4,N,29.144076480033032
174445,2067,5,1,6,Q,29.22814545058521
18090,2067,2,2,4,J,29.08372006497154
173466,2067,1,1,2,I,29.289860040934485
71725,2068,4,2,6,E,28.805043043432335
161407,2068,4,2,6,I,28.735573534480604
20504,2067,4,3,7,N,29.23002468233892
44386,2067,5,2,7,D,28.921205255020368
127832,2068,2,1,3,J,28.959503082449217
65880,2068,6,1,7,N,29.210380344429463
53367,2068,6,2,8,J,28.960430628120086
35969,2067,6,1,7,Q,28.972450175929342
102877,2068,3,1,4,N,29.018728187083763
86916,2067,3,1,4,A,29.337565114670102
127663,2068,6,4,10,P,28.762694934928597
51356,2067,5,0,5,S,29.011313439271145
116217,2067,5,2,7,J,28.96259899644265
147388,2068,3,2,5,J,29.004597079727212
51484,2068,4,1,5,N,28.835309251982903
150181,2068,3,2,5,P,29.02880937565825
111795,2068,8,2,10,N,28.5510427851508
99181,2067,1,1,2,K,29.382547877587765
32335,2067,5,1,6,E,28.842377562998905
74326,2068,4,0,4,E,28.877768170399925
95958,2067,8,2,10,C,29.44838971133149
31861,2067,5,1,6,E,29.23924691182376
180791,2067,3,1,4,Q,29.24138977616796
116146,2067,2,2,4,N,29.06163149118944
16266,2067,3,1,4,E,29.39324851055381
29549,2068,4,2,6,N,28.838997828273246
111966,2067,10,2,12,E,29.083637551981663
141315,2068,7,2,9,M,28.76705511522764
147784,2068,3,2,5,Q,28.97755508437836
46833,2068,3,2,5,Q,28.769759848954774
167746,2068,3,2,5,M,28.832249775013427
42097,2067,8,1,9,M,28.799833865705388
167531,2067,3,1,4,S,29.30038164139305
88957,2068,5,1,6,D,28.76647134470954
117229,2068,2,4,6,E,28.78213249915478
160594,2068,5,5,10,L,28.95290133082812
39457,2068,7,0,7,P,28.891983973058636
30917,2068,3,6,9,F,28.70601410876206
74560,2067,6,2,8,D,29.070092871702848
61570,2068,4,3,7,N,28.279955766686854
111415,2067,7,1,8,J,29.40704839492073
101396,2067,6,4,10,I,29.390124151907106
26592,2067,5,0,5,D,28.83406104973256
92009,2068,4,1,5,Q,28.797131281688817
40378,2067,4,3,7,S,29.072714304695538
73131,2068,4,0,4,N,28.82007068652623
62357,2067,5,1,6,E,29.431821134750287
16134,2067,7,0,7,D,29.19602640381321
41557,2068,6,2,8,N,28.793128165119807
89288,2067,8,0,8,P,29.2572322059808
78683,2068,3,0,3,K,28.809031167816823
97486,2067,7,2,9,A,29.07845223157012
161291,2068,6,2,8,A,28.95136117898181
122120,2068,6,0,6,Q,29.06678675327949
84358,2067,4,3,7,P,29.292961858644045
169897,2068,5,1,6,N,28.543023778168337
116438,2067,2,1,3,J,29.177687091740857
94335,2068,3,1,4,E,28.747446719511057
137683,2068,2,0,2,M,29.08888075707592
162788,2067,6,1,7,E,29.155611470002157
119292,2067,5,1,6,E,29.41680685202393
20011,2068,4,2,6,N,28.87830929896109
144821,2067,7,0,7,M,29.402829038229196
64472,2067,5,1,6,M,29.521078363805053
139177,2068,7,1,8,M,29.15990532167621
52409,2068,2,0,2,A,28.960783972892905
130568,2068,6,2,8,K,29.15968288462045
65632,2068,6,3,9,E,28.653912913442756
93576,2067,2,0,2,K,29.163231922114505
44722,2067,5,2,7,N,29.389198127494552
34635,2067,3,1,4,J,28.94623960859004
175209,2067,2,1,3,F,28.84069724446817
167303,2067,4,3,7,J,29.340017050312884
99783,2068,5,1,6,Q,28.98846776669173
139034,2067,6,2,8,N,29.39042928282513
139583,2067,6,2,8,N,28.925172785211185
172103,2067,7,0,7,R,28.979240691350267
86551,2067,3,2,5,Q,29.186345577029098
77696,2067,7,2,9,N,29.02625340857894
72553,2067,5,0,5,N,29.370394789580217
151398,2068,5,2,7,M,28.54763781251189
94100,2068,6,1,7,N,28.901236216275297
131708,2068,5,2,7,Q,29.121645145682454
117231,2068,7,2,9,J,29.20892002227973
155936,2067,3,2,5,F,29.487369728142653
51440,2068,4,1,5,E,28.79364707201454
16839,2067,5,0,5,M,29.139715594719476
119292,2068,4,0,4,E,28.88796343670727
178743,2067,3,1,4,D,29.19965905490312
93083,2067,6,1,7,D,29.287098281885044
100651,2067,6,2,8,N,29.076147610307853
65597,2067,3,1,4,D,29.093732214071515
185031,2067,13,2,15,P,29.34494095984021
119955,2068,10,1,11,E,28.925253956962266
134618,2068,5,2,7,N,29.004902364383277
105343,2068,4,2,6,N,29.136332109035717
91854,2067,8,1,9,H,29.07967446164908
51215,2067,4,1,5,E,29.30322589333248
177207,2067,5,1,6,I,29.30987615218606
70621,2067,4,2,6,N,29.40910714376314
101482,2067,6,2,8,L,29.07688907770853
118118,2068,7,2,9,N,28.757761190858705
109330,2068,9,3,12,P,28.76483181768326
18881,2068,7,1,8,K,28.67425510641777
24371,2067,18,2,20,E,29.131691146567256
113400,2068,4,2,6,P,28.977971160327545
182393,2068,8,1,9,M,28.86572542714193
47695,2067,2,2,4,P,29.245404584860417
23814,2067,5,0,5,D,29.11147621559812
157501,2067,4,0,4,P,29.33849451460364
33472,2068,2,0,2,E,28.93604811708905
21246,2067,4,1,5,N,29.262983212507013
96798,2067,6,0,6,J,29.095416018801508
164109,2068,2,2,4,E,28.78991582767801
124989,2068,4,0,4,K,29.00620981386925
58822,2067,19,7,26,P,29.013632748273324
23761,2067,4,3,7,P,29.22239788010507
166750,2068,3,2,5,M,28.92887630186334
39350,2067,6,1,7,P,29.09761610663558
147506,2068,3,0,3,M,29.0286992807054
55919,2067,3,1,4,S,29.24147268929172
62149,2067,1,1,2,P,29.16390212151732
183101,2068,3,1,4,M,28.53923896955788
67070,2068,4,1,5,E,28.74318362106471
136658,2067,3,0,3,F,28.97222079846492
176668,2067,7,2,9,P,29.16530265364652
81447,2068,4,2,6,J,28.702099747041142
86286,2068,3,1,4,H,29.2388109537857
53988,2067,2,2,4,Q,29.260170388584644
109257,2067,11,2,13,N,28.881372235100432
140506,2068,5,0,5,K,28.852274401156997
17132,2067,2,2,4,P,29.377431660579152
160350,2067,3,2,5,S,29.428411292039424
114036,2068,2,0,2,D,29.130850912670397
118290,2067,5,2,7,K,29.09444834929309
25335,2067,13,0,13,N,29.18008130321777
66203,2067,4,1,5,J,29.304498948026037
117200,2068,3,0,3,J,28.457791907028035
71717,2068,5,2,7,D,29.00451892998348
17551,2068,3,0,3,D,28.93024265856155
158427,2067,2,2,4,E,29.121451596072227
117363,2067,5,0,5,P,29.41479573471231
66010,2068,5,0,5,D,28.94044741402277
134231,2067,5,1,6,K,29.11321817485268
127085,2067,4,0,4,E,29.22273519962765
99309,2067,2,3,5,Q,29.44356574412516
111641,2068,4,3,7,E,28.844892464198598
182550,2067,6,1,7,M,28.950739431319374
55479,2068,2,0,2,Q,28.919182438625253
146915,2067,6,1,7,E,29.056170713006647
34380,2068,3,1,4,C,28.87609277000596
112514,2068,8,2,10,M,28.969724135468816
22467,2067,5,0,5,M,28.97170862616316
59144,2067,5,1,6,D,29.40149970456721
57542,2068,4,0,4,M,28.992050716692347
27997,2068,6,0,6,N,29.08545167153161
161951,2068,1,3,4,S,28.82959414570412
146463,2067,3,0,3,M,29.14617441663859
173253,2067,0,2,2,D,29.23367333903693
122266,2068,6,2,8,E,28.94110458329712
109902,2067,4,0,4,E,29.283523827007976
111175,2068,4,0,4,I,28.88601928629727
156616,2068,3,1,4,N,28.649172621694017
166802,2067,2,1,3,E,29.269822818934955
87483,2068,6,2,8,C,28.75366432914678
108849,2068,0,5,5,Q,28.974746322817055
100611,2068,2,2,4,Q,28.915565655368795
32792,2068,4,1,5,N,28.666566951790077
174520,2068,5,2,7,P,28.76591053953009
49536,2067,2,0,2,Q,29.56319459511696
111940,2068,5,2,7,E,29.058665551052265
127309,2067,6,1,7,J,29.3834138580404
170690,2067,6,2,8,D,28.968274882098815
98745,2068,4,4,8,I,28.486596142005645
48548,2068,8,2,10,H,28.983875834886323
72835,2067,3,2,5,P,29.212346194290035
105858,2068,4,0,4,N,28.804323538771836
109759,2067,2,1,3,J,29.36845390157904
145764,2067,5,0,5,E,28.952171647896648
83553,2068,4,1,5,Q,28.61659414805503
106298,2068,3,1,4,E,28.947197879913556
135165,2068,4,3,7,M,28.67142484020878
135672,2067,6,0,6,E,29.204214545350386
19442,2067,6,0,6,P,29.557300606716787
60034,2067,4,2,6,D,29.10267260251424
105843,2067,4,2,6,I,29.301623106226423
55606,2067,3,2,5,S,29.32231471267054
162590,2068,4,0,4,E,28.52016344780461
134819,2067,3,2,5,E,29.34816777322775
68523,2068,1,3,4,K,28.77572000606684
61868,2068,5,1,6,N,28.57309864091586
50160,2068,3,2,5,Q,28.907439183753024
132949,2067,6,1,7,E,29.286533564637597
20572,2068,4,2,6,M,28.862733588389865
128221,2067,7,1,8,N,29.193636923889567
116179,2068,6,3,9,E,29.13374904130554
53817,2067,6,1,7,E,29.43469846787563
40947,2068,2,1,3,N,28.752397936652763
158374,2068,4,2,6,E,29.13791056142071
110666,2067,3,2,5,J,29.16183586341069
55193,2068,5,2,7,Q,28.7732184008315
101739,2067,5,2,7,M,29.020729579271745
146965,2068,5,0,5,M,28.575015315789766
73520,2067,7,1,8,D,29.201441863323147
22067,2067,4,2,6,D,29.32934081446404
114788,2067,6,0,6,K,28.97391288489891
150522,2068,6,1,7,M,28.84460363807128
161043,2067,5,0,5,E,28.860436087610957
170690,2068,2,1,3,D,28.96995391720641
170798,2068,2,0,2,N,28.589406676689272
78863,2068,4,3,7,D,28.77446234589606
133308,2068,7,1,8,J,28.71074489313228
29553,2068,3,2,5,K,28.885834850718023
30248,2067,4,1,5,E,29.24380112398229
20893,2068,6,0,6,F,28.61758690945812
91665,2068,3,2,5,D,28.794228931515185
31223,2068,7,1,8,K,29.19693797000424
103246,2067,8,2,10,J,29.53256861220973
61857,2068,4,0,4,P,28.96098990029317
106492,2067,6,2,8,H,29.402062560344216
130278,2068,6,1,7,J,28.812053583532578
163487,2068,4,0,4,E,28.877590965243908
86172,2068,6,1,7,N,28.883899636637203
22913,2068,6,1,7,M,28.894196975463743
20961,2067,2,3,5,N,29.341482505449356
139271,2068,8,1,9,P,28.86965357047911
28753,2067,5,0,5,D,29.388841303190297
17917,2068,3,2,5,M,28.70605048002277
54904,2068,3,0,3,Q,29.21898189521871
28731,2067,1,2,3,N,28.97239161823746
175111,2068,5,2,7,E,28.575035336005808
110906,2067,5,2,7,J,29.08570856262657
149582,2068,5,2,7,P,28.905537887597085
148123,2067,7,1,8,M,28.97794440495261
125107,2068,6,3,9,P,28.730023533451806
24091,2068,1,5,6,A,29.05421885879229
33581,2068,4,0,4,E,28.858778364384964
58749,2068,14,2,16,Q,28.67804794710732
127908,2067,4,1,5,P,29.187816166579417
88897,2067,1,3,4,N,29.12776891551766
93608,2068,6,2,8,N,28.690760141771364
127184,2068,2,2,4,P,29.06945537141174
96832,2068,4,4,8,J,28.735439679390588
109866,2067,8,1,9,E,28.98885992809896
129171,2068,3,2,5,E,28.873957681774943
25410,2068,2,1,3,C,28.77920309535993
21886,2068,4,0,4,Q,29.012105536584976
146606,2067,3,1,4,M,29.18098917525112
165787,2068,3,2,5,M,28.877087599859436
37851,2068,5,2,7,E,28.6796698114424
82991,2067,5,1,6,N,29.139037014628958
39200,2067,6,2,8,N,29.309286579449743
17044,2068,12,3,15,A,28.85566657530206
82475,2067,6,2,8,Q,29.295709937733328
139813,2068,4,2,6,M,28.793448578138403
158880,2067,5,1,6,E,29.4898582108762
59363,2067,5,1,6,E,29.414784553493668
24038,2068,15,2,17,D,28.712302949279657
108768,2068,3,3,6,Q,28.910256330147888
148655,2068,10,1,11,P,28.81048275371628
68240,2068,6,2,8,A,28.7476254506386
166450,2068,4,2,6,M,28.953185586409077
87863,2068,4,1,5,C,28.89231676828895
167956,2068,3,2,5,Q,28.79908853889624
132887,2067,7,4,11,K,29.23749412284749
35471,2068,5,0,5,Q,28.96496738711724
17868,2067,3,4,7,K,29.235140539714276
79580,2068,6,0,6,M,28.933097972539628
177012,2067,7,1,8,E,29.349663022713862
95718,2068,2,0,2,P,28.821144106435455
169573,2068,4,2,6,P,28.73983040231101
182614,2068,5,2,7,M,29.10572205268735
55102,2067,7,1,8,J,29.02896313291152
71403,2067,5,1,6,M,29.58901891699325
142808,2067,6,2,8,K,29.000098356243967
90330,2067,6,0,6,M,29.47533180196195
17821,2068,5,1,6,E,28.478766508248555
70168,2068,5,0,5,P,28.95211090879216
79153,2068,7,1,8,Q,28.94092220855716
163439,2068,5,0,5,E,28.92051589720999
127875,2067,6,2,8,P,29.439959811816053
128464,2067,2,0,2,N,29.101308205129843
19154,2067,9,1,10,A,29.175793095203137
124204,2067,4,1,5,P,29.35226117792103
103635,2068,6,1,7,P,29.212732676839416
81787,2067,6,2,8,N,29.071089903665875
143440,2067,3,2,5,N,29.326252140062177
56247,2067,11,0,11,Q,29.21211011563933
48739,2067,6,0,6,E,29.306776179894133
115587,2067,3,1,4,E,29.258650591705827
81694,2067,2,2,4,Q,29.52049779594648
112450,2067,3,0,3,P,29.357442027406325
180601,2068,4,1,5,N,28.67171535838738
75656,2067,2,0,2,Q,29.4301347591989
100845,2067,4,2,6,J,29.135041539934683
111388,2067,5,1,6,K,29.11883358316804
173856,2068,1,2,3,N,28.541519199344847
133675,2067,5,2,7,N,29.03670373835486
137621,2068,13,5,18,K,28.603320298411283
167351,2068,6,3,9,S,28.774514038282437
48311,2068,5,2,7,Q,28.839158973787068
92888,2067,7,0,7,N,29.48221251282312
129950,2068,6,1,7,P,29.089218749897285
147077,2067,3,2,5,K,28.876468494701783
86313,2067,3,2,5,E,29.17837729501093
140057,2068,6,0,6,K,28.94702542599809
124399,2068,8,1,9,M,28.98292345234036
21071,2067,4,1,5,M,29.018047774999697
120720,2067,6,2,8,N,29.20321904441627
106870,2068,7,2,9,J,28.968913820571
116821,2068,6,1,7,P,28.78951439332826
131380,2067,4,1,5,N,29.458472247922774
22806,2068,4,2,6,M,28.510918287120617
86946,2067,2,0,2,K,29.41902423383561
171194,2068,6,1,7,E,28.91699861991039
18170,2068,3,1,4,S,29.07066971229914
150740,2068,3,4,7,M,28.915912222034148
17084,2067,6,0,6,J,28.95694701460092
63510,2067,8,5,13,P,29.241046895832227
148765,2067,5,2,7,M,29.19309428887433
107777,2068,6,2,8,E,28.643334723332377
35201,2068,6,0,6,Q,29.05503862042355
82442,2068,7,2,9,J,28.75866261811536
112382,2068,2,2,4,M,28.78306396629497
49688,2068,9,2,11,I,28.93218658802546
101935,2067,1,3,4,P,28.996790556392742
78139,2067,1,6,7,S,29.44504815123961
125315,2068,4,1,5,M,28.736522018443875
20999,2068,4,2,6,K,28.695679990611197
88158,2067,4,1,5,P,29.13020388082471
84274,2068,7,3,10,M,29.100353363529983
29489,2068,5,0,5,E,29.148654633190016
147810,2068,6,2,8,S,28.657178124799657
110678,2068,11,1,12,P,29.16557795944344
111142,2067,1,1,2,N,29.278260712558318
145324,2067,2,0,2,S,28.99777990928224
87688,2067,8,0,8,E,29.63741510217692
139410,2067,5,0,5,Q,28.912173405176286
63961,2067,5,2,7,E,28.968209241630717
130032,2068,10,4,14,P,29.18489397300488
27796,2068,2,1,3,A,29.06499096686968
147336,2067,3,2,5,K,29.281471378302047
112113,2067,4,1,5,N,29.442828055354283
48839,2067,3,1,4,E,29.16400494277245
99488,2068,3,1,4,E,28.84678611077853
93757,2068,9,4,13,S,28.78763165219079
132397,2068,4,4,8,I,28.803053936751866
17486,2067,3,1,4,N,29.164156140244756
124449,2067,5,2,7,M,29.28794460001808
23983,2067,5,1,6,A,29.2670038558411
51894,2068,4,0,4,Q,29.18337155515873
97785,2067,4,2,6,N,29.312183180648116
90390,2067,5,3,8,S,29.16532208511637
51746,2067,2,1,3,E,29.163406887777604
81504,2067,3,2,5,A,29.20448630233042
134526,2068,3,2,5,M,28.925630767006297
82546,2068,6,0,6,J,29.22071173297604
148420,2067,4,1,5,M,29.303119299393604
139404,2068,5,0,5,M,28.77239852258121
177826,2067,2,2,4,N,29.37493018028504
166511,2068,2,1,3,E,28.79130385924592
117112,2067,2,2,4,I,29.00759160556296
143906,2067,5,2,7,M,28.962200222118963
107995,2068,4,1,5,K,28.905253263050263
172199,2067,2,3,5,P,29.23717132792382
27524,2067,5,2,7,N,29.406361396773665
29006,2068,3,2,5,E,28.58672726841386
61046,2068,4,0,4,H,28.88567618595884
107440,2067,14,6,20,A,29.172594195725384
165750,2068,5,2,7,J,28.804482691491184
122657,2068,9,5,14,I,28.830335498608896
47267,2067,7,3,10,J,28.838076757913395
30801,2067,5,3,8,N,29.15182531391817
170630,2068,5,2,7,A,28.529805873939274
116861,2067,4,2,6,J,29.15028970475054
135338,2067,4,1,5,N,29.26591525952289
99001,2068,5,1,6,E,29.32651351766144
95592,2067,5,0,5,E,28.86450677550219
137932,2067,3,1,4,M,29.07356846090296
20531,2067,2,3,5,E,29.139470998449053
121068,2067,6,1,7,N,29.37019712845832
110273,2067,16,2,18,H,29.329280621283303
62991,2068,2,1,3,P,28.94531444273324
25791,2068,3,1,4,M,28.95484198305592
97992,2068,6,0,6,N,28.971464116575124
33085,2068,3,0,3,E,28.65225903769921
35481,2067,3,1,4,E,29.459409260868163
131914,2068,5,0,5,M,28.968184518459637
156658,2067,4,1,5,Q,29.203355800837805
106948,2067,7,0,7,Q,28.95590754661513
25236,2068,5,0,5,E,29.19484546297325
102999,2068,4,2,6,K,28.6776923667779
29964,2067,5,3,8,P,28.89071698292665
68037,2067,6,2,8,P,29.38185346102256
25439,2067,6,2,8,J,29.14071077496537
77589,2067,4,5,9,G,29.41770890597939
185029,2068,20,2,22,P,28.784832488506797
22691,2067,6,2,8,E,28.907721893122726
129550,2068,8,1,9,J,28.557332192766168
143678,2067,5,2,7,M,29.174558938113048
172886,2068,5,1,6,M,28.84979651285561
141253,2068,4,2,6,E,28.78856642334689
145120,2068,7,2,9,D,28.72726725777197
174777,2068,4,2,6,E,29.01996360211287
133883,2068,5,4,9,P,28.76320927549201
140288,2068,6,1,7,P,28.96840893292399
81393,2068,4,2,6,D,28.82640872837243
16111,2068,4,0,4,Q,28.788503472249317
73066,2067,5,2,7,D,29.05705318424531
127669,2067,3,1,4,P,29.175070941434758
93482,2068,4,1,5,Q,28.99396719613481
104609,2068,3,0,3,J,28.848266832328644
57350,2068,5,2,7,M,28.76443398226211
143631,2067,3,2,5,M,29.55471205236372
95507,2067,5,4,9,F,29.431994806936952
144416,2068,8,0,8,N,28.80923050126944
93460,2067,2,1,3,E,29.189473793136823
78339,2068,3,1,4,N,28.64511431870065
150695,2068,5,0,5,M,28.69438985238597
120498,2068,5,3,8,E,28.698955876546187
111457,2068,3,0,3,E,28.947864972414266
27706,2068,3,1,4,Q,28.852618767234112
134703,2068,4,2,6,E,28.640346000371476
91799,2067,2,2,4,N,29.039822071387853
135590,2067,5,2,7,J,29.00332682981057
128695,2067,4,0,4,E,29.09444763448344
158500,2068,6,1,7,J,28.92723969269934
170115,2067,2,4,6,N,29.136778543799668
121115,2068,10,4,14,M,28.887016446911822
104557,2067,1,2,3,N,29.3310274365221
96160,2067,4,2,6,N,29.34641172465544
164882,2068,4,2,6,C,28.6875803044606
160264,2067,5,1,6,N,28.91156344695752
129411,2067,1,4,5,M,29.20342851765037
125581,2068,5,1,6,K,28.88893154087744
115596,2067,5,2,7,N,29.02442732378564
123266,2067,9,9,18,I,28.9972804438702
71266,2068,3,2,5,Q,29.13548364841186
142612,2067,3,0,3,P,29.44250645135036
116524,2067,7,0,7,K,29.580110110651788
72698,2068,2,2,4,N,28.747053498239865
71402,2068,1,2,3,P,29.008455410601485
103253,2067,4,2,6,E,29.05948818125168
41619,2067,4,1,5,A,29.37693983151789
172095,2068,3,2,5,E,28.76748124622436
130566,2068,4,1,5,C,29.02868243035477
133706,2068,6,1,7,E,28.79268115622888
51233,2067,4,1,5,A,29.356954508940564
123742,2067,4,0,4,H,29.35715065045606
32627,2068,9,2,11,E,28.89111937376703
148720,2068,4,2,6,M,28.87797111038932
181908,2067,6,2,8,D,29.410606464035872
172869,2068,5,0,5,D,28.736057331802165
52701,2067,4,0,4,P,29.191963130573228
135597,2068,3,2,5,N,28.707442709014543
25834,2068,6,0,6,Q,28.88274887638353
175700,2068,2,5,7,S,28.852275875328225
180407,2067,2,1,3,Q,29.36202834211019
82036,2067,3,1,4,D,29.17028544034662
30416,2068,4,1,5,Q,28.720279952915917
113348,2068,2,2,4,N,28.73748521388733
137389,2068,4,1,5,H,28.968759005168906
77181,2068,5,4,9,Q,28.765438745963703
60372,2067,7,2,9,D,29.37475401450427
25410,2067,5,0,5,C,29.07456423778937
32337,2068,5,2,7,Q,28.72215811509868
46608,2068,2,1,3,Q,29.029565299428043
135610,2067,5,1,6,K,28.96894152029274
167096,2068,3,3,6,M,29.128444279683013
36527,2068,2,2,4,M,28.487642891124622
47637,2068,3,2,5,Q,28.708132000499088
98561,2067,3,1,4,C,29.08006936024061
146162,2067,3,2,5,J,28.934266597153865
65182,2067,5,2,7,J,28.92846605588037
78497,2068,4,0,4,E,28.89771170108229
48041,2068,11,2,13,D,28.79026034971069
103055,2068,1,3,4,N,28.82966977019753
24830,2067,3,2,5,Q,29.053498530365623
25832,2068,5,1,6,C,28.795443481196788
160253,2067,6,0,6,A,28.74962088838787
161073,2067,1,1,2,E,29.20235521740247
46178,2068,2,3,5,J,29.047060781057954
40128,2067,5,1,6,I,29.220282666839736
128099,2068,11,1,12,P,28.906757611734967
111322,2067,3,0,3,Q,29.044106956624336
144428,2068,3,1,4,N,28.63947527876506
81608,2068,3,1,4,E,28.976037696754272
131293,2067,7,4,11,M,28.97391302637224
64214,2067,3,2,5,D,29.49941740209575
56564,2067,11,2,13,E,29.59885482140216
55326,2067,6,2,8,D,29.001074653287475
47176,2068,6,2,8,N,28.954838305529663
142466,2068,4,0,4,M,28.78817032407969
32247,2067,2,2,4,J,29.01650589865102
115382,2068,4,3,7,N,28.8714153079844
82368,2068,6,1,7,J,29.114254110668416
118521,2068,6,2,8,P,28.836426054672582
64656,2067,5,0,5,M,29.60453085942796
136152,2067,4,1,5,E,29.1189005027036
29893,2068,5,0,5,E,28.98177891406659
174551,2067,6,2,8,E,29.21162378123066
126771,2068,2,1,3,E,28.793835994127782
99822,2067,1,1,2,S,29.42017300756658
172661,2068,8,2,10,F,28.5566355654134
107740,2067,6,0,6,J,29.02683345428786
25401,2067,12,0,12,H,28.953069946066723
31235,2068,6,2,8,E,28.796554735732613
108299,2068,6,1,7,E,28.51588155372123
89685,2067,1,3,4,J,29.35934495843724
76526,2067,2,1,3,N,29.14144481929128
82422,2067,4,2,6,Q,29.22996888982969
64961,2067,6,0,6,N,29.20892388321804
28161,2068,3,1,4,M,29.031063335999388
113367,2068,5,0,5,Q,28.99965217441082
47355,2067,3,1,4,M,29.0089416017077
104447,2068,4,0,4,E,28.82422475886404
131265,2067,14,3,17,E,28.770682633359275
130554,2068,2,1,3,J,29.12667405723618
93140,2068,6,2,8,N,29.072303048578075
147191,2068,5,4,9,M,28.925609666916525
175352,2067,5,3,8,M,29.128237742542503
44367,2067,5,1,6,E,29.250194076800927
183041,2067,4,0,4,M,28.94712552483962
55634,2067,5,2,7,S,29.33258933386579
85158,2068,1,4,5,E,29.106497474244545
119458,2068,6,2,8,E,28.802338744915872
175959,2067,8,2,10,Q,29.337221560336143
131469,2067,8,0,8,D,29.56074697298117
166234,2067,3,2,5,M,29.051193010829238
140057,2067,4,0,4,K,29.04596998104481
95728,2067,3,2,5,E,29.229210340972724
104288,2068,7,1,8,E,29.077696623589752
40826,2068,3,2,5,M,28.738080496924805
182662,2068,7,1,8,J,28.91900757317242
95878,2068,3,1,4,M,28.8730238893935
44509,2068,5,2,7,E,28.751731484801287
167132,2068,8,1,9,E,29.018362759763725
160787,2068,3,2,5,P,28.825950159926133
98766,2068,3,1,4,J,29.132468414707244
76715,2068,3,3,6,P,28.837023612218218
64860,2067,9,1,10,J,29.310302211327148
97711,2068,2,0,2,E,28.57309439054794
75199,2068,6,2,8,E,28.839065999711707
119159,2067,4,4,8,E,29.125799850622816
106180,2068,2,3,5,E,28.81274292195745
120429,2067,12,5,17,E,29.24252293522825
137556,2068,3,0,3,M,28.880706391505058
65925,2067,3,1,4,E,29.027423928807963
138454,2068,4,1,5,M,28.64801191542873
37379,2067,6,0,6,N,29.38979838908948
81375,2067,8,2,10,D,28.98540362323797
44323,2067,4,1,5,N,29.03262387854312
52244,2068,3,3,6,N,28.853807791988597
111501,2068,4,0,4,P,28.605146234628076
170994,2068,4,0,4,E,28.843440868608734
104741,2067,5,2,7,K,29.11928193205687
85627,2067,2,1,3,P,29.2032235529744
160069,2068,5,4,9,J,29.04582003303645
146003,2068,6,2,8,Q,28.621975839530133
96980,2067,2,2,4,N,29.210493308955837
47022,2068,8,1,9,N,28.7728368955386
145363,2068,3,4,7,M,29.032527925167475
95122,2067,1,2,3,E,28.852901761842645
66136,2068,6,1,7,H,28.48279940012503
117633,2067,7,0,7,E,29.291818280102653
126904,2067,2,1,3,E,28.99524401961457
100167,2067,3,1,4,E,29.385872787572747
46875,2067,6,2,8,D,29.08962796079982
72462,2068,5,2,7,E,28.78841371510693
179535,2068,2,2,4,H,28.85333975831494
22453,2067,13,0,13,M,28.7887181209387
112160,2068,3,1,4,E,28.907544673031065
29218,2067,6,2,8,K,29.101969561732613
93065,2067,6,1,7,P,29.211562825927103
157225,2067,6,1,7,K,29.457316414969576
96075,2068,3,3,6,N,28.875248910772857
144804,2068,7,2,9,P,28.9466521766154
158621,2068,3,3,6,D,28.97369897772341
108848,2068,6,1,7,M,28.80807021789388
19745,2068,7,1,8,E,29.008901610366888
177016,2068,4,0,4,N,29.197469051729048
44993,2068,2,0,2,E,29.06297005973648
139069,2068,5,2,7,M,28.81840113957831
121760,2067,5,1,6,J,29.102552391578097
157203,2068,6,1,7,A,29.075318771195736
55969,2068,6,2,8,S,28.80755322242459
108726,2067,3,2,5,E,29.146681457851663
145822,2067,5,3,8,N,29.306246629873996
89864,2068,4,3,7,F,29.072724272319174
133223,2067,4,0,4,Q,29.09621609563203
137876,2067,1,3,4,P,29.268617390447613
23413,2068,5,2,7,D,28.70105533794182
107872,2067,5,2,7,I,29.21542525629169
86017,2067,2,1,3,P,29.067304719549576
76521,2068,5,2,7,D,28.395945735775925
42371,2068,7,2,9,F,29.06690771018241
148918,2068,10,1,11,P,29.0636924240296
162791,2067,1,3,4,E,29.134900024717066
120544,2068,4,1,5,E,28.819293436186243
140609,2067,3,3,6,M,29.31192194865434
135240,2067,4,1,5,M,29.088477073227097
179416,2067,3,0,3,S,28.969054536160407
104071,2068,7,2,9,K,28.311208440423982
123393,2068,7,2,9,E,28.7958162417146
18418,2068,10,4,14,N,28.980535541118908
103764,2068,6,0,6,N,29.117835535205568
108885,2068,4,2,6,P,29.002014415337765
123759,2067,4,1,5,E,29.21520240378222
110444,2068,2,2,4,C,28.98689517104424
142298,2067,3,3,6,M,29.184139973718903
38927,2067,4,3,7,N,29.335847883234862
143265,2067,4,1,5,E,28.848268359695773
62722,2068,4,4,8,N,28.50128017285233
74267,2068,8,2,10,S,28.83159976158667
70972,2068,7,2,9,D,28.459108746581297
36218,2068,5,1,6,N,29.28200163185997
77581,2068,7,5,12,M,28.917357374695403
129584,2068,5,0,5,S,28.83886674517449
138989,2067,4,2,6,Q,28.98373191744035
39942,2067,7,1,8,M,29.041300695583
17905,2067,5,0,5,S,29.15737149566208
127579,2067,3,2,5,Q,29.29280439840766
33890,2067,3,2,5,E,29.29572673116311
53124,2067,3,2,5,N,29.436577261910628
30141,2068,5,2,7,P,28.86693149959812
111439,2068,8,0,8,J,28.87274436685812
49982,2067,5,1,6,E,29.30199305699793
54950,2068,4,3,7,M,29.036681264279583
108567,2068,6,0,6,A,28.947453761608013
112443,2068,1,3,4,S,28.547937304764545
129325,2068,8,1,9,D,28.707713651806777
50043,2068,1,3,4,E,29.15006213287185
93723,2067,6,2,8,E,29.29655198036681
71767,2068,5,2,7,J,28.964742923079346
91720,2067,3,1,4,J,29.176941650395623
157424,2067,1,1,2,J,28.93613458448389
52121,2068,6,1,7,E,28.93364692076979
123453,2068,5,2,7,Q,29.02360348851852
176313,2067,5,2,7,N,28.932023553053455
62131,2067,2,0,2,S,29.21245489419636
170614,2067,7,0,7,D,29.368792624733157
137621,2067,8,2,10,K,29.271992395281845
135906,2067,4,3,7,N,29.21068107871566
127083,2068,4,4,8,S,28.40681830569354
46604,2068,3,0,3,E,28.61921183473684
171218,2067,4,2,6,N,29.268904499712715
49488,2067,6,1,7,S,29.356668856612483
169958,2068,7,0,7,D,29.06280612861545
176143,2067,6,1,7,E,28.9353709200625
125954,2067,4,1,5,N,28.84495479248556
25354,2068,3,1,4,D,28.821859150141265
48727,2068,4,1,5,P,28.820828565533706
109117,2068,5,1,6,P,28.74394110705126
143062,2067,5,1,6,M,29.267037548969785
131337,2068,4,3,7,P,28.9618544525025
76256,2068,5,0,5,A,29.124721113081176
169692,2067,4,2,6,D,29.20092917366129
95290,2068,2,1,3,Q,28.607939309894302
150108,2068,4,1,5,P,28.84748009504354
107640,2067,6,1,7,D,29.24914823481117
183225,2068,5,2,7,E,28.944919957245222
98428,2067,3,2,5,E,28.951966923654656
128582,2067,2,1,3,A,28.955946276233117
27517,2067,3,1,4,P,28.955152310505632
98299,2067,7,0,7,J,29.243763322686323
166438,2068,2,1,3,P,28.886440626007765
93220,2068,2,3,5,E,28.6111735820558
93677,2068,3,3,6,J,28.868330290248977
72413,2067,5,0,5,E,29.43652767507456
148009,2068,6,0,6,M,29.01009482953655
140767,2067,1,3,4,D,29.17647209261048
60597,2067,2,1,3,E,29.202427172574414
49077,2068,6,3,9,E,28.95554263333159
36591,2067,6,1,7,Q,29.326729267361934
137986,2067,2,0,2,E,29.32543658457354
147367,2067,6,0,6,Q,29.32834485144235
111247,2067,6,2,8,E,29.05088884578937
142266,2068,4,1,5,Q,28.955112341676063
75247,2068,5,3,8,Q,29.053603414341243
41859,2067,7,0,7,K,29.29140156659673
101884,2067,8,0,8,J,29.3677126933916
146910,2068,7,1,8,M,28.719136225428176
169638,2068,5,1,6,D,28.896527993437275
182146,2067,6,2,8,M,29.188279978501704
51972,2068,3,1,4,E,28.69015908666258
100863,2067,5,1,6,Q,29.762451845254763
135906,2068,2,2,4,N,28.898752342851992
72306,2068,6,0,6,Q,28.995370538825654
167635,2068,6,0,6,A,28.807376567671305
60902,2068,4,1,5,D,28.83476747116757
147701,2067,5,1,6,M,29.215738684091352
111667,2067,7,5,12,N,29.07439887304649
78725,2067,3,3,6,M,29.003220056428404
144663,2068,6,1,7,M,28.812194223111216
114357,2067,8,1,9,E,28.90209743397975
124242,2068,4,2,6,P,29.114624454015534
114167,2067,8,1,9,J,29.163280202196137
73851,2067,1,1,2,P,29.518197680411845
39978,2068,6,0,6,D,29.036702125915543
38689,2067,5,2,7,N,29.235623641391207
95534,2067,4,2,6,N,29.056012680253318
37734,2067,1,4,5,N,29.198208484416067
32518,2068,6,1,7,E,28.569655320590734
134282,2067,3,0,3,E,29.11134769471417
81488,2068,4,2,6,D,28.887732564786194
185024,2068,10,1,11,P,28.88270787777437
110606,2067,4,3,7,E,29.24287825767267
124173,2068,6,4,10,I,28.775275641153332
87090,2068,7,0,7,E,29.069195547552766
83110,2067,3,2,5,Q,29.42084879047725
179452,2067,4,1,5,S,29.16146441126825
158297,2068,7,0,7,J,28.68715081328896
108812,2067,5,1,6,J,29.120880349950077
181694,2068,4,2,6,M,29.085632970096917
82073,2068,5,2,7,E,28.744506539610043
37962,2068,3,2,5,E,28.69969752272156
24955,2068,2,1,3,P,28.7024008733766
131727,2067,6,1,7,S,29.210836638536936
135932,2068,6,0,6,E,28.620193571654063
77575,2068,2,1,3,E,29.02595755308098
159607,2068,5,2,7,E,28.49980390325092
60089,2068,5,3,8,E,29.331835760035425
25406,2068,2,3,5,J,28.601481098558523
27728,2068,5,3,8,F,28.91717929635244
26320,2067,3,0,3,Q,29.5467189565626
71266,2067,7,2,9,Q,29.307222913641027
26920,2067,5,2,7,K,29.31078533941523
93654,2068,3,1,4,D,29.01711108385303
101910,2067,3,3,6,E,29.365554212969887
54803,2067,4,1,5,D,28.82600698419575
156034,2067,7,2,9,N,29.31350502359787
181151,2067,5,1,6,C,28.987430614258223
56064,2067,2,2,4,N,29.253123446239584
140857,2067,5,0,5,E,29.185964322835243
148579,2068,3,0,3,M,28.804222338036837
164673,2068,3,1,4,A,29.027090877378097
62776,2068,2,1,3,R,28.93078682406877
120002,2067,9,1,10,P,29.196835414625845
102395,2068,3,4,7,J,28.904573981101887
20800,2068,5,1,6,K,28.64150426490736
46467,2067,9,2,11,M,29.33243739217934
140680,2068,6,0,6,P,28.82747209657319
73561,2067,4,1,5,D,29.390607368964638
144306,2067,6,2,8,M,28.92726955363911
102991,2068,6,0,6,Q,28.699163818496416
25315,2067,9,1,10,P,29.226685199336075
135329,2068,1,1,2,J,28.946899649123797
143259,2067,4,2,6,S,29.187355828355344
53780,2068,2,1,3,E,28.95275233451497
181292,2067,7,2,9,D,29.03212436632521
181219,2068,13,0,13,N,28.935099686621072
25847,2067,4,0,4,J,29.38010059789448
143437,2067,5,0,5,N,29.369454471308337
107471,2068,7,2,9,A,28.914896733751394
66932,2067,7,1,8,M,29.33492668272901
23850,2068,13,1,14,Q,28.967196898926343
62478,2067,5,3,8,M,28.93598228895267
59644,2068,4,2,6,Q,29.002081429267022
72795,2068,5,0,5,F,28.854416077363616
90250,2068,3,3,6,Q,28.55066582116722
145433,2067,6,4,10,M,29.05124001476948
108652,2068,2,0,2,G,28.594011120562268
178787,2067,2,0,2,E,29.336018860845638
99190,2067,4,2,6,P,29.32733533015704
128226,2068,7,0,7,E,28.86196089658372
148751,2068,7,2,9,C,29.1993878531094
47030,2067,4,3,7,S,29.179014006063703
62126,2067,2,1,3,E,29.36523078982688
50726,2067,5,2,7,J,28.9370753877174
106596,2068,11,5,16,H,28.913332086484044
94217,2068,7,2,9,E,28.903699672417645
30071,2067,4,3,7,J,29.077954316523545
176341,2068,4,2,6,K,29.04971517645217
47548,2067,4,3,7,E,29.31366074403094
167363,2068,7,2,9,J,29.18460471121137
65523,2068,3,1,4,D,28.750231470832883
145857,2068,3,1,4,K,28.52944365510774
119780,2067,4,4,8,N,29.133906824374204
147494,2067,5,1,6,M,29.26493379339685
16437,2067,4,3,7,N,29.540939326516177
62678,2067,2,2,4,P,29.271450709615355
164893,2068,4,3,7,I,28.864660662940526
172563,2067,5,2,7,N,29.27472738434972
67532,2067,6,1,7,E,29.08495485194376
139681,2067,6,2,8,K,29.08742815637255
118127,2068,4,3,7,E,28.893977711316825
149936,2068,6,0,6,P,28.88762315528726
52272,2067,5,0,5,E,29.1889522073694
71717,2067,6,1,7,D,29.16345166348459
32607,2068,6,2,8,Q,28.96383317268593
133791,2068,4,2,6,M,28.568834418445643
183312,2068,4,2,6,M,28.990567281285543
134257,2067,3,2,5,Q,29.10509484638421
101293,2068,6,1,7,I,28.81830203070976
19731,2068,6,1,7,E,28.81022311004623
89268,2067,4,0,4,C,29.4251555130224
45659,2067,8,2,10,A,29.527736543121847
110813,2068,2,2,4,P,28.784431177373552
142886,2068,2,3,5,P,28.62609061105114
140163,2068,6,3,9,J,28.65386377813704
19926,2068,6,1,7,E,28.693092522288296
157676,2067,11,2,13,H,29.316121613478124
103437,2068,7,2,9,M,28.70150695558595
160386,2067,6,0,6,D,29.200513855102557
123675,2067,3,1,4,J,28.9478308560207
28113,2068,5,2,7,E,28.85200404354469
16032,2067,6,2,8,J,29.35343649643904
51082,2068,2,2,4,P,28.560822749460176
166346,2068,1,2,3,E,28.8327933397978
63559,2068,9,1,10,D,29.02269654873377
100771,2068,5,2,7,N,28.7789460841955
127516,2067,5,1,6,M,28.82277809466458
110077,2067,6,2,8,K,29.379135475110584
146292,2068,8,0,8,P,28.831394165617013
85231,2068,5,1,6,D,28.875158651139937
165626,2068,6,0,6,J,28.98953417696956
50603,2067,2,2,4,P,29.52931068913748
157034,2068,6,2,8,E,29.02023307514728
58833,2067,1,1,2,N,28.89078913979831
81403,2067,15,2,17,Q,29.22811055284196
26095,2067,2,3,5,Q,29.198048558569678
101068,2068,4,1,5,N,28.58592971487289
64601,2067,4,2,6,Q,29.16480500310989
83302,2068,6,1,7,S,28.971117204508413
125522,2067,5,1,6,K,29.219492738704503
138561,2068,8,2,10,E,28.750172803721647
22395,2068,6,0,6,Q,28.763357433783185
132089,2068,2,0,2,K,28.89469614455222
78780,2067,4,2,6,Q,29.30883514652534
111825,2068,4,1,5,P,29.007507853034035
114579,2068,3,3,6,J,28.8931807532636
63862,2068,4,3,7,J,28.88462382745148
110407,2067,5,1,6,N,29.175889232921097
64528,2068,2,3,5,Q,29.34374898631859
178763,2068,2,2,4,C,29.07593970795901
142584,2068,4,1,5,I,28.74422207430112
37168,2068,5,0,5,S,28.762000802965364
91579,2067,5,1,6,E,29.0627144004507
146923,2068,8,0,8,M,28.8412477156228
74884,2067,5,2,7,E,29.041936315172887
173180,2067,6,1,7,N,28.97990021991309
58877,2067,9,1,10,E,28.955908792421937
93886,2067,3,2,5,Q,29.354028795037603
113611,2068,6,2,8,J,28.83765178727934
71604,2068,5,4,9,E,29.052581391590955
36376,2067,4,1,5,J,29.171273045503035
156829,2067,7,3,10,N,29.15050993166469
165747,2068,5,0,5,M,28.9439075284218
108726,2068,2,2,4,E,29.06832238341429
85798,2068,4,1,5,J,28.89578399250877
170692,2067,1,3,4,E,29.20677636572729
58660,2068,5,3,8,P,28.77462715196173
132189,2067,7,2,9,K,29.02203191482521
93934,2067,9,1,10,E,29.10291532882516
99415,2068,4,2,6,P,28.57668132787222
156018,2067,4,1,5,N,29.232885820285805
159781,2067,3,1,4,N,29.165048195375448
145209,2068,3,0,3,M,28.980271667944905
100918,2067,3,1,4,J,29.208688693466147
148298,2068,5,2,7,M,28.497327375400214
177178,2068,7,2,9,D,28.8740968042994
140415,2068,3,2,5,M,28.776417327012556
144175,2068,6,1,7,Q,28.91121857436655
22055,2068,6,1,7,M,28.933181724175448
182063,2068,5,1,6,Q,28.74360341090917
45868,2068,3,2,5,E,28.89617004832721
97424,2068,4,1,5,N,28.790238170373414
63671,2067,12,4,16,N,29.31740429072393
75464,2068,3,1,4,N,28.788718722470865
96391,2068,5,2,7,R,28.59265148764401
129111,2067,4,1,5,K,29.097454901646245
39885,2068,5,3,8,Q,28.60710670386198
83883,2068,2,2,4,N,28.546991018521588
129705,2068,4,0,4,J,28.989223460684027
94393,2067,3,1,4,M,29.160827485478304
148057,2067,4,2,6,M,29.022331349257485
177664,2068,4,1,5,P,28.70277596135047
15857,2068,7,1,8,A,29.05412715359413
101579,2068,4,3,7,D,28.640509202437777
121231,2068,6,2,8,S,28.887690010240124
102809,2067,3,0,3,S,29.63796770809832
144693,2067,2,2,4,J,28.86749165236646
121790,2067,10,3,13,P,29.319104887619527
171123,2067,7,1,8,D,29.099894816111725
23398,2067,6,0,6,Q,29.305867120672342
34874,2068,5,1,6,C,29.182898004842937
70446,2068,5,2,7,K,28.651750454943524
38164,2068,7,0,7,J,28.76571006694807
54506,2068,6,0,6,J,28.82452618381558
106376,2068,6,1,7,K,28.79967396750669
161461,2067,6,2,8,E,29.16556715163538
128328,2068,2,2,4,M,28.974867976868477
59101,2067,2,0,2,J,29.21056446559056
113202,2068,5,3,8,L,29.14922118908385
166117,2067,6,1,7,C,29.351419039304705
84024,2067,2,1,3,P,29.09321039230665
92278,2067,5,0,5,P,28.941646606202788
149426,2068,5,1,6,M,28.698580819945857
104135,2068,5,0,5,M,28.59956255440493
109136,2067,1,2,3,M,29.30356517492351
130165,2067,5,2,7,J,28.937652746777587
121095,2068,1,1,2,E,28.74355244714246
109631,2067,4,1,5,E,29.537751819620443
150480,2068,5,2,7,M,28.787894262142604
175619,2067,5,3,8,E,29.176585189059026
44481,2067,5,0,5,N,29.31086629186419
173674,2067,6,2,8,N,29.26440565686848
20763,2067,2,1,3,N,29.087572397687914
92417,2067,4,0,4,E,29.45178890772116
109215,2067,4,2,6,E,29.35489694354533
164210,2068,7,1,8,N,28.796253365521142
72432,2067,4,1,5,J,29.46962765985675
30492,2068,11,0,11,E,28.989547555208414
93733,2068,3,0,3,J,28.741953678388317
42099,2067,5,2,7,Q,29.28147200295167
37319,2067,4,1,5,E,29.51493865178372
103948,2067,5,1,6,K,29.57619781874116
61305,2068,3,2,5,Q,28.970634831449782
148987,2068,4,1,5,M,28.921902301213745
81739,2067,5,0,5,C,29.28150415609953
143025,2068,5,0,5,P,28.92338394787253
169361,2068,4,1,5,D,28.848883206274454
64295,2067,2,3,5,D,28.957776077017044
62620,2068,4,0,4,N,28.963798165765
174018,2068,7,0,7,N,29.16888314378008
40512,2067,3,2,5,N,29.394913166196297
37530,2067,6,3,9,N,29.100608520140916
110919,2067,5,1,6,J,29.31562048634257
41207,2067,5,1,6,E,29.45207955231829
83755,2068,5,2,7,C,28.78897439945797
135318,2068,3,0,3,E,28.60757312513808
107537,2068,6,2,8,Q,28.962104858550735
118353,2067,1,2,3,K,28.720423289790343
60529,2067,4,1,5,D,29.015779615293276
92461,2068,9,5,14,I,28.70904914396001
97843,2068,6,0,6,N,28.817681176253085
132725,2067,8,2,10,M,29.01700080569608
49075,2067,3,1,4,N,29.27569570581327
63982,2068,3,2,5,N,28.749929381247195
110848,2067,6,3,9,M,29.222395875453618
73121,2067,7,2,9,A,28.5895401093242
26231,2067,3,2,5,F,29.10339592959913
142403,2068,6,1,7,Q,29.00826785348456
107970,2067,4,1,5,K,29.31582542786684
145923,2068,5,0,5,M,29.003506866579364
172692,2067,7,2,9,D,29.2394721179344
61668,2068,9,2,11,D,29.104323225080364
170439,2068,2,1,3,J,28.545868722106565
170005,2068,12,1,13,D,29.14318967039082
87031,2068,4,0,4,D,29.030364400397406
148901,2067,2,0,2,J,29.59717959672787
84771,2068,5,1,6,N,28.73863934658205
123013,2068,7,0,7,K,28.85504973404384
53040,2067,2,2,4,J,29.259714976305
97992,2067,3,1,4,N,29.53770538636609
142722,2067,3,2,5,N,29.38473018568081
20816,2067,5,2,7,N,29.289557378454976
169442,2068,5,0,5,D,29.15243401233666
33198,2067,6,1,7,L,29.13765554204188
113878,2067,11,4,15,J,29.11284563803308
131254,2068,3,3,6,M,28.892439121766547
149578,2068,6,1,7,S,28.575754861922206
65785,2068,4,2,6,E,28.883449524466947
31488,2068,5,2,7,D,28.980631976607302
151423,2068,5,2,7,P,28.737976950582706
70915,2068,5,0,5,N,28.69111684470535
95218,2067,2,2,4,N,29.424965133297132
86752,2068,3,1,4,P,28.962188832405165
77798,2067,5,0,5,E,29.332399247911024
100831,2068,3,0,3,N,28.64151826574452
147049,2068,7,1,8,J,28.64849768348556
72298,2068,5,1,6,K,29.10350081448191
19626,2068,6,3,9,S,28.90506515408696
120866,2067,6,2,8,S,29.53091292239707
99513,2068,3,2,5,P,29.01040858742044
124078,2068,4,2,6,I,28.795177763399032
73419,2068,2,1,3,N,28.64009720339372
46929,2067,4,4,8,J,28.7990961231302
122526,2067,4,1,5,Q,28.82379861874344
21302,2067,3,2,5,J,29.23017097713964
140024,2068,3,2,5,M,29.02699132471484
90641,2068,6,2,8,M,29.12085635428093
19837,2067,3,2,5,G,29.08144137258568
41192,2067,6,0,6,J,28.94929657133176
75972,2068,3,4,7,M,28.806708745436552
60369,2067,5,1,6,P,29.10415397579199
61340,2067,1,3,4,J,29.141662426239808
132073,2068,5,0,5,N,28.99989732696842
167531,2068,6,0,6,S,28.955540891674666
64704,2067,6,2,8,D,29.1595236281914
34211,2068,7,0,7,H,29.1241832253596
126969,2068,1,3,4,J,28.90116837785673
40011,2068,7,2,9,E,29.010396104848557
133309,2067,2,1,3,J,29.1952666922092
181756,2067,2,2,4,N,29.43006467527901
62089,2068,5,1,6,E,28.67794268501696
66129,2067,6,3,9,N,29.327728700989823
123654,2068,6,1,7,N,28.712663319878853
120643,2067,2,3,5,M,29.27292220352678
65214,2068,6,1,7,D,28.75913857276969
149844,2068,4,1,5,M,28.66971373217405
48862,2067,4,3,7,S,28.997042388900752
144152,2067,4,1,5,E,28.999931498051488
160910,2068,4,3,7,N,28.69913157601598
59352,2067,5,0,5,E,29.098269228116656
111885,2068,4,2,6,E,29.067328911149502
94949,2067,2,0,2,J,29.262793381045704
125152,2067,3,0,3,M,29.49901119430818
59816,2068,1,1,2,E,28.861407747976354
102230,2068,0,4,4,N,29.054423030482365
117527,2068,8,0,8,J,28.90530333176336
67412,2068,5,1,6,E,29.068826853866145
118998,2068,5,3,8,N,28.842221189065867
26410,2068,2,2,4,N,28.66317561802899
31474,2068,3,0,3,E,28.83429761408058
82620,2068,6,2,8,M,28.29833612388555
121211,2068,6,2,8,J,29.13848253389304
101303,2068,7,2,9,A,28.773138956357627
157219,2068,3,1,4,A,29.04812133118356
148667,2067,3,1,4,M,29.20323822223796
69388,2067,5,2,7,N,29.336469630976318
120767,2068,6,3,9,N,28.56425385216215
106565,2067,3,0,3,N,29.21547431753111
131625,2067,6,1,7,M,29.264650745368787
84389,2067,16,3,19,M,29.406881028730567
20596,2068,4,0,4,D,28.74712548666454
96566,2067,3,2,5,D,29.371592204633576
56127,2067,5,1,6,M,28.900159955487087
39588,2068,6,0,6,N,28.78100775256721
66920,2067,6,3,9,A,29.206851616816653
71358,2068,8,2,10,P,29.07298096490188
179087,2067,3,0,3,E,29.25960862503311
167438,2068,6,0,6,J,28.73211901376688
175594,2067,5,2,7,N,29.24099065969176
15857,2067,10,2,12,A,29.39985164137951
141479,2068,5,1,6,P,29.100532547528463
171919,2067,1,3,4,E,29.133592971632176
90377,2067,5,1,6,M,29.25433469355996
142589,2067,3,2,5,A,29.12880501873361
159231,2068,5,0,5,Q,28.88925283918505
102875,2067,5,1,6,Q,29.09413036754926
167867,2067,8,2,10,M,29.12923551033888
78893,2068,10,6,16,F,28.750802165608025
144079,2067,9,1,10,E,29.23018170289426
128466,2068,4,2,6,J,29.039761883817388
157421,2068,6,2,8,K,28.78005533571511
128472,2068,6,2,8,M,28.809967191357984
28379,2068,7,0,7,E,28.99710775296509
64884,2068,7,2,9,E,28.74895559359704
59880,2068,1,2,3,N,29.120550122668856
121238,2068,3,3,6,E,29.080804396122044
93509,2067,2,3,5,J,29.29418122426694
99977,2068,3,1,4,K,28.854123347368706
135317,2067,3,1,4,E,29.04087103047341
52710,2067,4,1,5,J,29.293297398031704
96917,2067,2,3,5,E,29.12864303775662
82711,2068,3,1,4,D,28.86984152383185
37824,2068,7,2,9,E,28.78032386941909
78499,2068,7,1,8,S,28.96628496228745
71072,2067,6,1,7,J,29.160736573620134
16632,2067,4,1,5,P,29.06843409957308
180601,2067,4,1,5,N,29.32479822261364
46242,2068,5,0,5,E,28.82233849834726
116844,2068,8,3,11,E,29.09880363949352
133586,2068,5,1,6,M,29.35355814099256
78249,2067,4,1,5,M,29.08655426155759
76727,2067,8,2,10,N,29.387250195362544
164231,2068,3,2,5,S,28.88915385323454
113413,2067,3,2,5,E,29.218472153037187
103935,2068,6,3,9,N,28.92324565399351
130932,2068,5,2,7,R,28.77583085499156
163013,2068,2,1,3,E,28.94069448436345
65623,2067,7,2,9,D,29.439604589441604
63908,2068,6,2,8,D,29.04581547317208
141740,2067,4,0,4,P,29.479508657533504
34894,2068,5,0,5,Q,28.75027154277789
171750,2067,4,0,4,P,29.207355320757827
114030,2067,4,3,7,E,29.0115728271264
157119,2068,2,2,4,M,28.78944746369711
66180,2068,12,1,13,E,28.8665963184764
55637,2068,9,1,10,Q,28.870582482444004
100039,2067,2,2,4,D,29.349861602830536
143491,2067,8,0,8,P,29.19717267993635
60547,2068,17,2,19,N,29.12360062429107
140894,2068,4,2,6,E,28.55306465825172
92039,2067,6,1,7,E,28.913937743346917
46615,2067,4,4,8,E,29.060360794975868
77862,2068,3,0,3,P,28.746035923903975
130211,2068,4,1,5,J,28.932735467654016
181987,2067,2,2,4,K,29.24507671798694
132009,2068,3,2,5,C,29.17867453618836
111282,2068,5,3,8,N,29.18134909750885
68793,2068,6,0,6,P,28.80326024414149
62377,2067,1,1,2,E,29.18140206872325
66411,2068,6,0,6,D,28.950020491879812
101743,2067,8,2,10,M,28.664506536656727
82469,2067,5,1,6,E,29.328760735064552
118089,2068,2,1,3,J,29.022930871367308
46385,2068,6,4,10,J,29.057331704200408
147943,2067,5,1,6,M,29.100263229517815
94540,2068,4,1,5,N,28.997783434846728
139214,2067,4,2,6,N,29.124659669008715
75122,2068,4,2,6,D,28.83774572097972
72546,2067,5,2,7,N,29.418957804684613
91870,2068,1,2,3,N,28.970424554396807
23441,2068,2,3,5,N,28.56403907262601
93877,2068,7,0,7,E,29.02793915403858
41609,2068,5,0,5,Q,28.539640452666664
89966,2067,5,0,5,Q,29.00969873206725
45890,2067,5,2,7,N,29.448137955389274
24274,2067,6,0,6,J,29.134168106957866
59227,2068,7,1,8,N,29.13412989714379
108532,2068,3,1,4,D,28.77749920388569
132160,2067,2,1,3,M,29.111913365227743
142096,2068,3,2,5,Q,29.130908128547727
24559,2068,5,1,6,D,28.711176649262644
45138,2067,6,2,8,Q,29.324270482622072
148797,2067,6,0,6,M,28.9446442191893
84515,2068,6,1,7,Q,29.02130682898172
93203,2068,6,3,9,N,29.06816196642472
83493,2067,5,3,8,I,29.18774678629946
144791,2067,7,2,9,M,29.305862912124542
26532,2068,5,1,6,M,29.0849012708479
109058,2068,2,1,3,E,28.67348576844972
118849,2067,3,1,4,J,29.038554775762503
93035,2068,2,1,3,K,28.94906133883399
148152,2068,4,0,4,P,28.95251907573372
145187,2068,8,0,8,E,28.73136099205969
31611,2067,6,1,7,K,29.32812075835588
148322,2068,6,2,8,M,28.765398251283592
127470,2068,5,2,7,N,28.786643437539755
131281,2067,3,3,6,Q,29.381510858491325
59064,2067,4,2,6,Q,29.205044426183537
166257,2068,4,3,7,M,28.62288433560528
93872,2068,4,0,4,N,29.10844677776353
96899,2067,4,0,4,M,29.318560206391584
124046,2068,4,0,4,Q,29.144643209443657
74332,2067,2,1,3,Q,28.93879074887341
35644,2068,5,0,5,D,28.802566770094508
144975,2067,6,0,6,N,29.30195154307636
129397,2067,1,4,5,C,29.338463956844578
24795,2067,1,1,2,N,29.3633344471005
142016,2067,7,1,8,M,28.88522887960264
26175,2068,3,2,5,A,28.970838136854844
70905,2068,4,1,5,D,28.83955678113557
101579,2067,5,2,7,D,29.046612201085228
67437,2067,5,1,6,P,29.18853303192633
100770,2068,4,2,6,P,29.017998030039053
45070,2068,4,0,4,D,28.766193680001216
24464,2068,7,2,9,N,28.92426921402417
60967,2068,4,4,8,Q,28.583490765016023
94911,2068,3,2,5,N,28.89381687735699
41184,2067,3,1,4,P,29.39200058772275
106667,2068,8,2,10,E,28.85956106703781
156105,2068,2,1,3,E,28.761444701826026
143026,2067,4,0,4,M,29.058205494699184
71679,2067,2,2,4,P,29.269019313511983
50294,2067,3,0,3,N,28.95926425409549
67041,2068,8,0,8,K,29.04815149554828
61642,2068,9,3,12,N,28.932894914197718
100755,2068,3,1,4,J,28.72863323958903
176932,2068,3,0,3,N,29.19746838119108
62409,2067,3,2,5,G,29.12677526238029
143183,2067,8,0,8,P,29.4306039093188
176614,2068,5,3,8,P,28.731878290683948
114035,2067,4,4,8,N,29.396794231947048
42322,2068,6,2,8,G,29.014686438048788
26582,2067,7,0,7,N,29.21644193484686
139595,2067,3,2,5,M,29.27886821473392
136738,2067,5,2,7,R,28.76953715138896
116973,2068,4,1,5,P,28.728758181376303
51769,2067,4,1,5,N,28.686627605448663
37783,2068,6,3,9,K,28.65911437357183
146084,2068,4,2,6,E,28.80725052099468
149840,2068,3,3,6,M,28.81925958957077
142477,2068,4,1,5,E,29.04345421978249
118423,2068,4,3,7,P,28.95771446855475
75153,2068,3,1,4,D,28.950565758568228
180866,2068,3,3,6,M,28.89998090792661
161628,2068,3,3,6,M,28.92737533569866
177804,2067,3,1,4,J,29.341949472114347
56262,2067,5,1,6,Q,29.30639929664677
132781,2067,3,0,3,P,29.18836322197477
134677,2067,5,1,6,N,29.14580744507576
149923,2068,5,2,7,P,28.847566114484163
114343,2068,6,2,8,N,29.02131035322113
109790,2068,3,2,5,H,29.025359635621616
164672,2067,4,1,5,M,29.31419174810988
41332,2068,5,1,6,K,28.97026657164341
159056,2067,6,2,8,P,29.28493029265948
135876,2068,5,1,6,J,29.323016109130528
137810,2068,5,2,7,D,28.889335649079538
130458,2068,4,1,5,K,28.80571669330864
24830,2068,4,1,5,Q,28.84235009580557
99348,2067,1,2,3,M,29.21010256095042
97547,2068,12,1,13,Q,28.872754899470326
114190,2068,7,2,9,J,28.910533233753384
69425,2067,4,2,6,D,29.298133714583354
48595,2068,5,0,5,Q,28.74096133603364
158759,2068,6,0,6,N,28.501555146799053
60053,2068,1,1,2,P,28.901749351950897
137990,2067,6,2,8,Q,29.20763802444157
159507,2067,5,1,6,M,29.21868002088989
47460,2068,3,1,4,M,29.266939339275904
45048,2068,5,0,5,Q,28.957458592985496
148023,2068,4,2,6,K,29.084150279588272
65023,2068,2,2,4,N,28.916166927340857
135188,2068,5,1,6,P,29.209273064501097
36738,2068,5,1,6,H,28.855632363917064
73676,2067,7,1,8,Q,29.02851664130954
75824,2068,5,1,6,J,28.87320378223785
140833,2068,2,1,3,M,28.87579250273086
41222,2068,5,3,8,P,28.913308688811775
129435,2068,4,1,5,P,28.99055274731579
24297,2068,6,2,8,D,28.87048833297807
106311,2067,27,5,32,E,29.1335180972366
76145,2067,4,3,7,D,29.35723540872179
131782,2068,6,2,8,N,29.177938176750654
156101,2067,4,2,6,Q,29.17318564190628
130143,2068,6,1,7,A,28.65241666437472
156527,2068,7,2,9,N,29.00333327158312
54347,2068,6,2,8,J,28.938768842369864
86053,2067,2,2,4,D,29.146232814366343
143522,2068,7,2,9,E,28.92676423633892
144477,2068,3,1,4,K,28.761341883973483
158633,2068,6,2,8,H,28.941681287918115
157654,2067,3,2,5,S,29.424451735793195
126771,2067,3,0,3,E,29.189854939157257
144662,2068,7,2,9,M,28.71025130225384
33572,2068,2,3,5,M,28.89907962280368
77977,2067,4,1,5,D,29.135606768180477
150435,2068,1,3,4,M,28.500756143260773
62605,2068,4,2,6,Q,28.75926760747112
95113,2068,3,0,3,Q,28.85037927582814
112657,2067,3,5,8,E,29.15949865117132
24986,2067,2,1,3,Q,29.016772395252065
147319,2068,6,2,8,J,28.814223574002963
159046,2067,4,0,4,E,29.212358131990136
55755,2068,3,2,5,L,28.60183501636839
164709,2068,5,2,7,M,29.028082043677216
124920,2067,7,1,8,M,29.173897781483547
46982,2068,2,1,3,J,28.92983968903231
119711,2068,6,0,6,N,28.977697321614063
50122,2067,5,2,7,M,29.29828397786346
47682,2068,4,0,4,E,29.007811367508907
123956,2068,2,1,3,M,28.58186499424681
131819,2067,4,2,6,N,29.128585736807945
90133,2068,3,0,3,E,29.15114189544731
76586,2068,4,2,6,N,29.085174570033416
59294,2067,10,2,12,D,29.09792599230577
78278,2068,6,0,6,Q,29.06519640968196
127934,2067,3,2,5,J,29.219964549876995
146333,2068,3,3,6,E,28.69681506325704
41705,2067,6,1,7,N,29.26787582855472
107453,2067,4,2,6,F,28.88282512355149
138804,2068,6,2,8,N,29.192178525250625
103917,2067,8,1,9,K,29.19429555845672
88979,2067,7,1,8,A,29.434025571580136
49765,2067,4,1,5,E,29.136789076525165
144998,2067,5,1,6,A,29.28905645846666
182580,2068,2,0,2,Q,28.84349663428623
155943,2067,6,0,6,D,29.30704066000901
40205,2067,6,0,6,Q,29.165346882249764
33385,2067,5,2,7,E,29.34618209486632
67438,2068,3,1,4,N,28.77705618795224
146921,2068,4,1,5,M,28.900370662043212
124072,2068,3,1,4,Q,28.947962666914048
82057,2067,5,2,7,Q,29.005507003027876
64941,2068,7,1,8,D,28.75996195065661
132570,2067,3,2,5,E,29.14609852899759
180318,2067,6,3,9,L,29.464255251445607
36008,2067,7,2,9,A,29.300336494803485
20436,2067,2,1,3,D,29.31571852326645
106966,2068,5,2,7,S,28.553283148600794
63307,2067,6,2,8,E,28.82005742853725
40665,2068,6,0,6,M,29.312064977476016
141862,2068,6,2,8,Q,29.18112855028041
67465,2068,5,2,7,N,28.98358289537312
135089,2068,3,3,6,N,28.89498693386939
97926,2067,4,0,4,N,29.157209742905923
121892,2067,3,2,5,E,29.35944964327602
20633,2067,5,1,6,S,29.147970376342357
177700,2068,6,2,8,N,29.03583753102009
171023,2067,4,2,6,D,29.31480943303533
68277,2068,3,3,6,E,29.103901080826397
148034,2067,4,1,5,M,29.186826284569545
106162,2067,4,3,7,J,29.27847327470975
146569,2068,6,2,8,M,28.83100592569672
144921,2067,7,1,8,A,29.27868418855688
46206,2068,8,2,10,A,29.04690008068973
176816,2068,4,2,6,N,28.792710108574884
147580,2068,6,3,9,Q,29.21799650514045
122926,2068,4,2,6,M,28.78006388804933
16809,2067,6,2,8,E,29.233409674624863
119018,2067,5,2,7,K,29.43928198356949
122850,2068,9,3,12,P,28.73475255001424
166843,2068,3,0,3,E,29.11514710240169
161870,2068,4,2,6,K,28.68819990972456
29619,2068,6,2,8,E,28.68941884383674
76985,2067,7,2,9,Q,29.26942288626229
136917,2067,3,2,5,M,29.1790736229038
36376,2068,4,2,6,J,28.73066143930393
18687,2067,4,2,6,E,29.103239720333285
24519,2067,4,1,5,J,29.381606481008216
24894,2068,10,2,12,J,28.703305814047827
123536,2067,5,2,7,M,29.013030797064243
156160,2068,5,1,6,J,28.648914664493383
133757,2068,7,0,7,K,28.92881455188102
135910,2067,6,0,6,N,29.009611487813704
67192,2068,5,0,5,J,28.82095838838292
146938,2068,4,3,7,P,28.838705672560177
29706,2068,2,1,3,E,29.126336193448303
54229,2068,7,2,9,J,28.605065169724423
39699,2067,11,1,12,N,29.332305382210592
138212,2068,4,2,6,N,28.958762426411337
179411,2067,5,1,6,D,29.34698271833386
28951,2068,5,0,5,E,28.97732660132156
175112,2067,4,0,4,J,29.23693434388136
162732,2067,1,4,5,S,29.30811716064491
23422,2068,4,2,6,D,28.815281899514783
171106,2068,2,0,2,Q,28.815058668061813
114183,2067,2,2,4,J,29.24869030667856
112417,2067,3,1,4,A,29.087026155448157
81804,2067,8,0,8,Q,29.363402089927785
61966,2068,6,3,9,E,28.82765889520013
171782,2067,6,2,8,D,29.20741955719478
28445,2068,4,2,6,E,28.776318864243244
34011,2068,6,2,8,E,29.233320183728377
175422,2067,5,3,8,I,29.00898501728904
146680,2068,7,2,9,N,28.7701976817772
118777,2067,4,0,4,P,29.148733564257743
173412,2068,4,1,5,E,28.824568807643608
41985,2067,5,1,6,Q,29.192456472748216
110461,2068,6,1,7,E,28.84760105871256
104727,2067,6,0,6,K,29.090496751487112
164840,2068,7,1,8,P,28.95149867945277
101019,2068,5,2,7,N,28.66780642146417
64523,2067,6,2,8,K,29.079332399257563
55386,2068,4,0,4,J,28.68683618332357
66288,2067,4,0,4,E,29.230926270319724
141215,2067,7,1,8,S,28.635572259991736
21431,2067,6,2,8,D,29.091875185563296
74918,2067,4,2,6,K,29.31065420018577
128046,2068,4,2,6,N,28.71851614635844
17306,2068,4,2,6,P,28.616412872598136
123642,2068,5,2,7,Q,28.867151199536373
87849,2067,5,0,5,K,29.059027469768303
112544,2067,2,3,5,I,29.321865162183453
159164,2067,5,1,6,N,28.900534695059044
17012,2067,7,2,9,E,29.245878907123803
142700,2067,3,1,4,M,29.258284484746
173648,2068,6,2,8,D,29.171570134155257
134448,2067,2,2,4,J,29.178273294211508
18783,2068,1,1,2,A,29.33520237658582
174523,2067,4,1,5,N,29.02673043899543
61776,2068,1,2,3,N,28.695803459343814
64219,2068,2,2,4,D,28.773439646252985
155890,2068,3,2,5,F,28.71497549377654
72432,2068,6,1,7,J,28.56251668439813
33368,2067,3,0,3,I,28.978065369117168
141042,2067,1,2,3,E,28.990371302689116
100921,2067,4,1,5,N,28.80492894083588
24111,2067,5,1,6,E,28.936796624481232
122563,2068,5,1,6,K,28.760218152376783
16114,2067,4,2,6,S,29.26766399072005
33448,2068,6,0,6,J,28.79442201097805
142065,2067,4,2,6,K,28.89275592228931
44293,2067,2,0,2,D,29.432190137735173
121119,2068,5,0,5,N,28.975060761607505
40215,2067,7,0,7,M,29.003404751780643
30465,2068,6,1,7,E,29.136451759550145
74861,2068,7,0,7,Q,28.42772722223602
95887,2067,6,2,8,P,29.27227451228639
119363,2068,9,1,10,K,28.862786280359902
147908,2067,6,1,7,P,29.475802606279743
116546,2067,4,0,4,E,29.022288266327063
174652,2067,4,2,6,E,29.06298596371104
20857,2068,4,1,5,Q,28.60939863794416
31762,2068,5,1,6,J,28.88194765181932
135696,2068,1,1,2,M,28.80954629014061
26836,2067,6,2,8,Q,29.07878698553046
22704,2068,8,2,10,E,28.938076029662856
41191,2068,4,1,5,J,28.8347031692718
162802,2067,2,1,3,E,29.067791574087387
155906,2068,10,2,12,A,28.647009648402943
66010,2067,3,0,3,D,29.393675261174657
66011,2068,2,3,5,N,28.825106601125643
182671,2067,7,1,8,A,29.040704086128663
115738,2067,3,3,6,E,29.17722199169636
106929,2068,7,2,9,E,28.70124267080937
18525,2068,5,1,6,E,29.036693144980447
15781,2068,2,2,4,E,28.68391795082645
22660,2068,2,0,2,N,29.085695634182795
99122,2068,6,1,7,E,28.76511135559547
118555,2068,4,0,4,D,29.147402951952326
26760,2067,7,0,7,P,29.10779024106519
170180,2067,2,1,3,D,29.04811569856349
115259,2067,5,0,5,M,29.24454690137348
98375,2067,8,0,8,E,28.95061472213404
179315,2068,2,3,5,M,28.850123203644586
136586,2067,8,2,10,K,29.080674202769
53061,2068,4,1,5,P,28.880020293247544
107629,2067,5,2,7,E,29.12784658887543
142054,2068,2,2,4,L,28.62140607242004
77301,2068,3,2,5,N,28.66554161434758
163053,2067,6,1,7,J,29.341488892629688
176516,2068,4,1,5,E,28.92858558819833
140874,2068,6,2,8,Q,28.746679658348647
67497,2068,5,0,5,Q,28.76261616748777
178328,2068,4,2,6,M,28.69742527526377
26689,2068,9,2,11,M,29.3814423692231
34274,2068,3,2,5,K,29.09227562668058
102643,2068,2,1,3,Q,28.980728442572005
51580,2068,7,0,7,K,28.74202468561361
170108,2068,2,3,5,D,28.7650829393132
144023,2067,3,1,4,N,29.241323672996412
102469,2068,6,2,8,E,29.05040049237132
110477,2067,6,2,8,E,29.12001140548947
56695,2067,3,0,3,E,29.17406343150086
55601,2068,4,2,6,N,28.90041776466097
148839,2067,5,2,7,P,29.00254472358898
176839,2067,7,0,7,Q,29.2813977729186
147006,2067,3,0,3,M,29.009627226170288
24535,2067,4,2,6,N,29.531807784471564
140568,2068,5,2,7,M,28.72416540722153
47648,2067,5,0,5,N,29.18523446244829
146928,2067,2,2,4,P,29.329569272933444
108774,2067,3,1,4,K,29.03389753596873
61819,2067,4,1,5,J,29.02159135350262
18914,2068,2,1,3,I,28.865377707833492
147561,2068,4,2,6,M,29.01996385005158
156865,2068,6,3,9,D,29.226011254109885
174403,2067,4,1,5,N,29.109773489436
144214,2068,3,0,3,E,28.48566149999749
157669,2068,7,0,7,E,28.752373213634836
168177,2068,4,2,6,D,28.965208660553103
160431,2067,7,2,9,Q,29.22096058283291
175736,2067,4,2,6,E,29.309607910016883
111227,2067,4,3,7,Q,29.123084798543097
24973,2068,11,5,16,J,28.88465071836653
123710,2067,1,1,2,N,29.264042213933894
132317,2067,6,1,7,N,29.30401689070237
76534,2067,5,0,5,K,29.607781449862543
124044,2068,3,2,5,Q,29.238263113369698
56857,2067,2,3,5,J,29.01387157574917
109865,2068,8,2,10,J,28.94426186843569
139651,2068,2,2,4,E,29.003657301464976
82696,2068,5,1,6,R,28.699363946260647
26189,2068,2,4,6,E,28.972522815745595
15856,2067,1,3,4,E,29.33550620799122
28374,2068,7,2,9,K,28.791902257396107
92845,2068,3,1,4,E,28.754596500304803
119271,2067,9,1,10,R,29.29895910896341
97716,2067,3,2,5,N,29.071041100095098
128270,2068,4,2,6,A,29.16928843182589
179580,2067,1,3,4,M,29.35830844648584
2180008,2068,13,1,14,P,28.667037301413146
141170,2067,6,2,8,Q,29.098295381198614
161547,2067,7,1,8,I,29.266475158026942
74072,2068,3,0,3,K,28.85661245292517
92982,2068,17,4,21,N,29.111470310488915
136425,2067,5,0,5,K,29.09781052871334
139124,2067,3,0,3,P,29.041390711180902
148758,2068,7,2,9,M,28.954445355827616
159021,2067,6,0,6,M,29.146003973998244
98619,2068,7,0,7,E,28.70460963865606
26557,2068,6,2,8,A,28.9213355367967
111474,2068,5,1,6,E,28.76702065910572
130998,2068,15,1,16,M,28.547504018304764
116474,2068,4,0,4,E,28.888590909065368
73063,2068,11,3,14,Q,29.1649286163781
53237,2067,5,2,7,P,29.31072005445285
180484,2068,2,1,3,M,29.136173819794568
133018,2067,1,2,3,E,29.08256533731908
75470,2068,2,2,4,S,28.866022785834048
166153,2067,6,2,8,M,29.033593723909505
141077,2067,6,1,7,Q,29.289230249087822
67329,2067,5,2,7,P,29.021801417117786
96471,2068,5,1,6,K,28.742453026094083
114715,2068,4,5,9,E,29.02252041838259
81634,2068,14,4,18,D,29.01855353043136
141313,2067,4,3,7,E,29.59149182736306
28910,2067,2,2,4,Q,29.19051208220097
120907,2068,4,1,5,E,28.98760261911742
48827,2068,1,2,3,D,29.133951304733447
172565,2067,3,3,6,D,29.157284515911307
107843,2068,5,0,5,J,28.76807701589524
90305,2067,2,0,2,J,29.192278578058637
93629,2068,3,2,5,Q,29.047305128690457
92627,2067,16,4,20,D,29.284442962003123
144664,2068,8,1,9,N,29.07149843598105
162730,2067,4,2,6,K,29.174519283599054
132221,2067,2,2,4,E,29.288207930340345
173733,2068,6,1,7,N,28.876263105069967
170602,2068,2,2,4,S,28.923989788543384
175324,2067,9,1,10,D,29.15499621192797
61984,2068,10,3,13,J,28.850252661817425
171710,2068,3,0,3,Q,28.897237807211923
98096,2067,8,0,8,J,29.32679844219935
94539,2067,6,3,9,N,29.19107423393853
132214,2067,7,0,7,K,29.20143250171624
145212,2068,3,0,3,J,28.789004703049528
59613,2067,3,0,3,D,29.517811661280284
156922,2068,2,3,5,E,28.88604853193709
134089,2067,3,2,5,P,29.411875105286885
175534,2067,2,3,5,J,29.29645823952345
108302,2068,6,1,7,N,28.91542640744199
160432,2068,5,2,7,E,28.76948110702526
148316,2068,4,1,5,M,28.92310221692365
24416,2068,1,3,4,N,28.60821683637505
24535,2068,5,3,8,N,28.99858184817925
123952,2067,5,1,6,E,29.541214277455754
95061,2067,6,1,7,N,29.18556420966847
71719,2068,5,1,6,P,29.219664996613865
103825,2067,7,1,8,E,28.880594628740145
146117,2067,4,2,6,A,29.272063373946317
23772,2068,2,2,4,J,28.974429665993256
15880,2067,4,2,6,D,29.07841113023456
99616,2068,3,2,5,N,29.122998296323612
106715,2067,7,3,10,K,29.390589287822426
150726,2068,4,2,6,M,28.980494217087205
32184,2067,5,2,7,D,28.92630851991838
96673,2067,3,2,5,D,29.353315364363155
162439,2068,8,2,10,E,28.924877035509223
150310,2068,6,1,7,P,29.12974509447137
46223,2067,5,1,6,E,29.07802158413691
99235,2067,9,4,13,M,29.057750211106644
33455,2068,5,2,7,C,28.60649517779036
96639,2067,7,2,9,D,29.031671534604836
2585189,2068,6,2,8,E,28.775015633785166
25747,2068,5,0,5,E,28.97920064415551
72865,2067,1,2,3,N,29.187865833011248
97388,2067,10,2,12,M,29.17179770717324
132853,2067,6,3,9,D,29.2701320955918
108688,2068,12,1,13,E,28.864653443002545
179257,2068,11,2,13,J,28.715951516031275
75914,2068,6,0,6,D,28.869359645217376
114360,2067,6,2,8,P,28.88383810752224
89235,2068,7,1,8,J,28.790635139337077
49570,2067,2,2,4,J,29.354574920400943
37305,2068,4,3,7,E,28.774650153917047
24392,2067,2,1,3,D,29.30530340031726
78754,2068,4,2,6,N,28.82973230313245
130846,2067,2,1,3,N,29.33529325465376
59528,2068,6,1,7,D,28.76735119867053
32080,2068,5,2,7,E,28.558015474767608
46399,2067,2,0,2,J,29.12887317617819
177638,2067,4,0,4,Q,29.149497404327768
145175,2068,4,3,7,M,28.994658434483327
99767,2068,4,1,5,Q,29.32911383451688
182134,2068,6,1,7,K,28.960505658934192
136729,2067,4,1,5,Q,29.106098920937782
108392,2067,4,1,5,F,29.16915903979344
172481,2068,3,2,5,N,28.77697040185465
101857,2068,6,6,12,P,28.75989421376494
145292,2067,7,0,7,Q,29.324765304625856
17265,2067,3,1,4,N,29.15733419558312
64026,2067,7,1,8,D,29.043495160448668
96668,2067,3,2,5,E,29.078271159649468
108535,2067,2,2,4,E,29.147385051930467
40742,2067,4,2,6,E,29.311317220249517
60083,2068,5,2,7,J,28.556257364540517
93366,2068,6,1,7,M,28.97923951049453
54369,2068,2,2,4,K,29.131481090333573
182543,2068,7,1,8,M,28.70416178533495
114946,2067,7,1,8,P,29.461008413122347
149005,2068,6,2,8,J,29.026197929475327
56345,2067,5,2,7,Q,29.23627526442932
25829,2067,3,0,3,E,29.35292519028314
110030,2067,5,1,6,N,29.375964252460104
157939,2068,2,2,4,N,28.751595012783184
48481,2067,4,1,5,N,29.397685717475017
86346,2068,12,0,12,E,28.697714709995736
134116,2068,4,1,5,M,28.71357811893029
58617,2068,3,2,5,D,28.7780434455026
131402,2067,4,4,8,N,29.202771108690445
101429,2068,7,1,8,D,28.821441444138895
113039,2068,4,1,5,N,28.928164495725053
144092,2067,7,0,7,S,29.438520184766737
127142,2068,7,1,8,E,29.07127412197114
89564,2067,4,0,4,P,29.13742537486774
20478,2067,5,2,7,M,29.36924392156884
103330,2067,4,2,6,F,29.298282685169283
172218,2068,3,1,4,J,28.79698287217975
22610,2067,3,3,6,M,29.451198384248727
125317,2068,2,1,3,J,28.552434341760343
75902,2067,2,1,3,K,29.22137224812518
44644,2068,4,1,5,N,29.04960178137646
133025,2067,7,0,7,P,29.101531207624557
53318,2067,7,0,7,Q,29.37487590604076
165657,2068,2,1,3,S,28.85677394128856
149163,2068,3,2,5,P,28.6861968351839
174261,2067,2,2,4,M,28.876782909571613
74749,2068,5,2,7,D,28.81955610284236
160909,2067,5,2,7,J,29.28533520781595
22072,2068,5,2,7,M,28.876966239027706
45322,2067,6,1,7,Q,28.921687817592524
161026,2067,3,0,3,M,29.13498308873709
20891,2067,4,2,6,M,29.416283802541013
101130,2068,9,1,10,J,28.753318460353704
66335,2067,4,3,7,E,29.267102523512403
47385,2068,5,2,7,N,28.96654863057776
159852,2067,5,2,7,E,29.427846174912062
140170,2068,3,1,4,M,28.745083328958696
147658,2068,9,0,9,P,29.2290573729638
146949,2068,6,2,8,N,28.85048535623075
136500,2068,2,1,3,Q,28.790362833334537
163138,2067,5,1,6,P,29.359004670481955
134102,2068,7,1,8,E,28.620833654759515
103046,2068,8,2,10,Q,28.769450608854
139509,2067,6,2,8,M,29.2244916582126
109317,2067,4,2,6,D,29.385494601614862
60651,2068,7,1,8,D,28.66113475273769
117229,2067,5,4,9,E,28.989498681025378
78861,2068,2,3,5,A,28.75856806324162
180944,2068,5,3,8,P,28.761759399621955
51920,2068,5,2,7,N,28.55968439579984
157001,2067,1,1,2,N,29.073660838857244
50235,2067,6,2,8,Q,29.095178979320437
136276,2068,3,0,3,D,28.80159577671167
78448,2067,5,2,7,K,29.03833332368216
61040,2068,1,1,2,E,28.816202673410626
99952,2068,2,0,2,Q,28.775858955040885
95011,2067,6,2,8,I,29.093161432952925
130817,2068,7,2,9,N,28.81453343373831
47288,2067,8,1,9,E,29.009795109189625
49189,2067,3,2,5,E,29.093509668913917
120274,2067,6,1,7,E,28.739701083705043
59544,2068,5,2,7,N,28.923724626650984
92683,2068,6,2,8,N,28.470643810333367
64793,2068,5,2,7,K,28.848934484292855
48045,2067,5,2,7,E,29.523524597016817
95069,2067,5,1,6,Q,29.277154139597847
143565,2067,5,2,7,D,29.006489394229018
101952,2068,8,3,11,E,28.74893720608277
140319,2067,5,2,7,J,29.14893302183765
139769,2068,5,2,7,M,28.629578769915184
86346,2067,10,1,11,E,29.613345348995136
176525,2067,2,0,2,N,28.897904382839084
114040,2068,4,0,4,P,28.93049469377773
175422,2068,9,1,10,I,28.762398896339068
159349,2068,9,1,10,M,29.199388302994578
47367,2068,6,2,8,Q,28.746459027187587
129671,2068,7,1,8,E,28.80363463281636
28259,2067,4,0,4,A,29.031063429140307
141785,2068,5,1,6,K,28.9564071978281
93427,2068,3,1,4,A,29.189325090329262
93650,2068,5,0,5,J,28.968198115532005
112205,2068,7,0,7,K,28.781731091437667
64941,2067,8,1,9,D,28.95196696876874
115522,2068,8,2,10,M,29.118466721947893
108210,2067,4,2,6,N,29.08504771785214
111508,2068,8,6,14,I,28.88413123408015
147493,2068,8,2,10,Q,28.82834134786617
101410,2067,5,1,6,P,29.22470767317792
61441,2068,4,0,4,D,28.75627899061485
19628,2068,7,1,8,M,28.850830463054415
169473,2067,2,1,3,D,28.92690755116465
69158,2067,5,2,7,N,28.908455387141395
177248,2067,6,3,9,F,29.167385185313275
173247,2068,10,0,10,D,28.935763022431424
143467,2068,5,2,7,E,29.225921181270937
121031,2068,6,2,8,E,28.61561944631248
179666,2067,1,4,5,N,29.13486608889861
142158,2068,3,1,4,D,29.15713997644701
72645,2067,7,1,8,J,29.25294565753856
158866,2068,3,2,5,E,28.791077801950912
156376,2067,4,2,6,N,29.09224128990151
27728,2067,3,3,6,F,29.023685132275013
65534,2067,15,4,19,E,29.259593386834837
81904,2067,5,2,7,Q,28.99284750038832
157645,2067,12,1,13,A,29.45013262203441
141858,2067,4,1,5,K,29.12707174652669
93227,2067,3,3,6,M,29.093938683373857
27578,2067,3,2,5,G,29.06833208082109
171320,2068,4,4,8,Q,28.935259653274827
17540,2068,5,1,6,J,28.831446901570303
71624,2067,5,2,7,M,29.064316170567235
150448,2068,4,3,7,S,28.83876018521646
44637,2068,5,2,7,D,28.974030364463363
46867,2067,4,3,7,J,29.564802636764927
128270,2067,5,1,6,A,29.13701621507101
95105,2067,6,1,7,N,28.958528069845244
120770,2067,2,1,3,P,29.039983893254888
180173,2067,4,2,6,N,28.96686431552217
139839,2067,1,1,2,P,29.137484388899708
66618,2068,5,2,7,K,28.856846817513244
81442,2067,2,1,3,J,29.454928754726023
65575,2068,4,2,6,D,28.577595946209403
99854,2067,3,3,6,N,28.91802854338967
143756,2067,6,1,7,E,29.228145576833423
21109,2068,6,1,7,M,28.61121560337123
178739,2067,5,3,8,N,29.285926984994724
40784,2068,4,0,4,E,28.781698162325657
99592,2067,5,0,5,J,28.81044799748197
108690,2068,4,1,5,J,29.069491652884786
135647,2067,5,0,5,E,29.188385999406474
41659,2068,6,3,9,J,28.865337956290112
137862,2067,7,2,9,K,29.50898909835408
116133,2068,4,2,6,N,28.928078650677698
167260,2068,6,1,7,Q,28.689259438478217
78777,2068,3,1,4,M,28.945756881047256
95796,2067,2,3,5,K,29.254048831845942
42262,2068,4,1,5,M,28.66996861427457
130634,2067,4,2,6,E,28.866863448598767
132402,2068,3,4,7,P,28.779432601105768
118981,2068,4,0,4,E,28.85256087402332
121985,2067,3,1,4,N,29.02218280425097
42076,2068,6,1,7,E,29.001288783856985
44947,2067,2,2,4,J,29.10488497967308
97890,2068,3,3,6,N,28.635125770216263
60538,2067,3,2,5,M,29.329101812240943
52241,2068,5,1,6,J,29.02838058404345
93699,2068,5,3,8,J,28.85404384463937
129318,2067,4,2,6,K,29.188327343139623
48280,2068,6,1,7,J,28.99659255668176
19920,2067,1,1,2,S,28.94751480716909
109839,2068,7,2,9,I,28.75787957264976
114694,2068,6,2,8,E,28.559063771637767
50701,2068,2,2,4,N,28.615460491756743
171750,2068,2,0,2,P,28.785293363642587
172123,2068,4,3,7,N,28.8561441114792
78601,2068,6,1,7,Q,28.80727949185079
114535,2068,5,2,7,P,28.937732329505963
142584,2067,5,0,5,I,29.24067333843889
90772,2068,7,0,7,H,28.798261586926948
131243,2067,4,1,5,Q,29.12918681601848
104577,2068,2,0,2,N,28.939146538234347
157483,2067,1,2,3,P,29.119452808584978
114169,2067,5,2,7,M,29.086966047800203
93311,2067,12,0,12,E,29.20429300635428
110912,2067,6,1,7,E,29.17359337269285
94613,2067,6,2,8,A,29.13485043005973
74223,2067,7,2,9,P,29.36733141666956
46547,2068,4,2,6,C,29.069475554048463
180608,2068,2,1,3,N,28.720883934249397
29130,2067,5,2,7,J,29.084438469033472
114090,2067,2,2,4,J,29.04014680811466
27986,2067,4,2,6,E,29.64307433299848
169792,2067,5,0,5,N,29.333804730990025
156133,2067,2,0,2,N,29.13276576835748
182590,2067,2,0,2,E,29.22642859521608
59429,2068,2,0,2,N,28.62029043328229
29572,2068,6,2,8,Q,28.89312737766356
174270,2068,6,1,7,J,28.739287451738537
38392,2068,4,0,4,N,28.931637767576994
41488,2068,10,0,10,P,29.156974932861367
131346,2068,3,5,8,P,29.06123533120478
58904,2068,5,0,5,Q,28.74845369701144
18400,2068,4,1,5,S,28.89595264610053
98449,2067,5,2,7,K,29.391358149027408
138932,2068,6,1,7,M,29.252592518990443
32635,2067,8,0,8,E,29.21920726104999
132744,2068,4,3,7,J,29.125321235717475
89679,2067,5,2,7,N,29.21527302616397
180125,2067,6,1,7,N,29.16260268111392
134382,2067,6,1,7,N,29.29163104853969
145246,2068,6,2,8,K,29.088936268971
65669,2068,6,1,7,N,28.968177796367367
162161,2067,4,2,6,J,29.19303346864632
137290,2067,5,1,6,M,29.152313037758702
28341,2068,6,0,6,E,28.711485830453853
89642,2068,6,0,6,M,28.69711607581969
167156,2067,6,3,9,N,29.34415105586273
142969,2068,6,2,8,M,29.11348938280163
110923,2068,7,2,9,Q,28.63288508181229
42272,2068,7,2,9,P,28.95133203333955
52656,2067,5,1,6,N,28.921883800596035
174246,2068,1,3,4,J,29.27496009128971
163464,2068,6,2,8,P,28.83998455323125
96135,2068,9,4,13,E,28.70516305877565
100463,2067,7,1,8,D,28.902498304909237
160637,2068,3,2,5,S,29.036248824431244
24108,2068,1,3,4,Q,28.9280410605936
102663,2067,6,0,6,K,29.106416622481916
25335,2068,17,2,19,N,29.053541639008817
38028,2068,4,0,4,K,28.75986852437465
145443,2068,7,2,9,P,29.104220706276976
20923,2067,3,3,6,I,29.08817244467912
122352,2068,3,1,4,F,28.91646548852382
71871,2068,7,2,9,E,28.834813367413265
61688,2067,2,0,2,J,29.126077511838325
67174,2067,3,2,5,N,29.19831096556675
35969,2068,3,0,3,Q,28.735173114459325
98995,2068,3,3,6,E,28.723669872034872
67371,2068,2,1,3,D,28.806110882606912
53136,2068,7,1,8,K,28.84857494521373
41104,2067,3,2,5,J,29.21266400626926
124764,2067,8,2,10,E,29.081615959259203
98407,2067,6,2,8,E,29.10945270445732
33385,2068,4,3,7,E,29.152835344893223
130347,2067,4,3,7,M,29.16397410760177
158813,2067,5,1,6,L,29.104686702212728
112898,2068,6,1,7,I,28.67236889763408
62488,2067,5,2,7,E,29.342899282285945
41452,2067,6,0,6,N,29.05617613204055
150104,2068,5,0,5,P,29.022895961581437
148909,2068,17,2,19,P,28.917087231744752
51920,2067,2,3,5,N,29.26146518729044
172247,2068,5,1,6,D,28.856873767403563
136948,2067,2,2,4,Q,29.107189968225647
114747,2068,7,4,11,E,28.73043417327785
85637,2067,3,0,3,L,29.369404918731984
100757,2067,2,1,3,E,29.220784690283494
62409,2068,7,2,9,G,28.937880374949536
181231,2068,5,1,6,Q,28.825858554095472
159022,2067,4,1,5,H,29.01128580778868
36161,2067,6,2,8,E,29.38529682525899
119964,2068,6,1,7,P,28.722604979362707
115608,2067,1,4,5,D,29.12033786277451
117011,2068,9,1,10,K,28.87557380464028
112468,2068,4,1,5,N,28.73663939821025
86848,2067,3,1,4,Q,29.36542947607001
25644,2067,4,3,7,E,29.274318347351645
37749,2068,4,4,8,P,28.97340725178748
27325,2068,5,2,7,P,28.867381651115345
134679,2068,7,4,11,L,28.813524226166106
41601,2068,5,0,5,M,28.44430495002369
131076,2067,3,2,5,J,29.42893350025579
151068,2068,4,2,6,D,29.01511088020669
48434,2068,2,0,2,K,28.86286949607552
137556,2067,3,2,5,M,29.10467327570949
84635,2068,7,1,8,E,28.74436651457578
157137,2068,11,2,13,D,28.824450345952503
67823,2067,7,1,8,E,29.19352940011552
117270,2067,1,2,3,A,29.105133993015095
179133,2068,6,2,8,J,28.72699106691982
138249,2068,2,4,6,A,28.772296493116134
112442,2067,3,1,4,K,28.78049124256612
98064,2067,5,2,7,Q,29.497222618840983
104599,2067,9,3,12,R,29.2944159804147
175630,2068,6,1,7,J,28.94583130633798
82336,2068,11,3,14,C,28.932866378771056
162732,2068,2,3,5,S,28.8567614162523
142403,2067,2,1,3,Q,29.061600194495952
132230,2067,5,2,7,A,29.15313281147029
182295,2068,3,3,6,Q,29.0123777604595
63555,2067,6,0,6,D,29.41704969199771
72909,2067,3,2,5,E,29.08929210061665
171138,2067,5,1,6,N,29.15194596576644
38130,2068,1,3,4,S,28.745606671950533
118472,2068,6,3,9,E,28.79601135626922
136181,2068,1,3,4,E,29.15929514472277
113666,2068,6,1,7,E,28.532365584567245
67383,2068,4,1,5,D,28.740402542753877
66186,2067,5,4,9,I,29.08406404280405
34722,2068,4,0,4,N,28.327927002120024
143024,2067,5,0,5,A,29.167598650302217
147263,2068,5,0,5,N,28.8114657274594
157874,2068,2,2,4,N,28.673287327540585
19950,2067,4,2,6,D,29.111760894249013
124286,2068,3,1,4,E,28.9612636338377
97662,2067,5,2,7,D,29.374580040733093
44330,2068,4,2,6,A,28.70808750175742
144308,2067,3,1,4,M,29.36077102125302
167734,2068,4,0,4,Q,29.03442965191059
147690,2067,2,2,4,Q,29.494740207063327
146438,2068,6,1,7,N,28.76626835382684
147152,2067,4,3,7,M,29.04430515866664
134654,2067,3,1,4,D,29.131261883830305
19649,2068,2,0,2,N,29.33672754723161
146079,2068,7,2,9,E,28.62466500420134
114566,2067,3,1,4,M,28.97921828724752
135800,2068,3,1,4,N,28.86458049762586
21299,2067,2,0,2,E,29.22472090750916
158728,2068,3,3,6,N,28.756011196781703
61245,2067,5,1,6,J,29.272343729612743
18995,2068,7,2,9,I,28.793366825673168
107995,2067,5,0,5,K,29.329220647744044
93351,2068,6,0,6,Q,28.806287751380264
29874,2067,4,1,5,D,29.38832136669892
79327,2068,2,2,4,E,28.88861929289265
68044,2068,3,2,5,N,28.83913497123237
137196,2068,4,1,5,M,28.61684398255296
146700,2067,3,1,4,K,28.911056312963936
180067,2067,4,0,4,Q,28.871371228337868
46932,2067,3,1,4,N,29.463633766607597
161634,2067,5,1,6,M,29.15536078271182
162042,2067,8,6,14,A,29.36880441387011
134381,2068,2,1,3,P,29.15714566359565
143354,2068,4,0,4,D,28.596804903744346
150083,2068,2,1,3,M,28.86245120759621
55487,2068,5,1,6,J,28.776000137538706
105347,2067,6,0,6,E,29.078051622000437
88415,2068,5,2,7,D,28.69587758096993
100423,2068,4,1,5,D,28.500298503942844
179422,2067,3,0,3,M,28.75954372193112
74848,2067,6,0,6,N,28.895172830380208
48693,2068,6,0,6,N,28.66368563897413
25622,2068,5,1,6,P,28.994040593914495
164411,2067,9,0,9,P,29.006134811791995
115208,2067,4,3,7,M,28.92730019807513
26325,2068,5,2,7,J,28.885999088721587
182573,2068,7,2,9,N,28.90102265020743
46514,2067,2,2,4,A,29.185467907997097
129711,2067,4,1,5,N,29.115230883547927
45927,2068,5,2,7,E,28.87997448536725
99179,2067,12,2,14,E,29.006902480477343
